what is the sex of <e> 's darling	joseph_e_davies	female	spouse|gender
what is the son of offspring of <e>	chulalongkorn	nakkhatra_mangkala_kitiyakara	children|children
why <e> 's dad died	postumus_junior	assassination	parents|cause_of_death
the location of daughter of <e>	john_elector_of_saxony	coburg	children|location
the cause of death of <e> 's spouse	adolf_hitler	suicide|cyanide_poisoning	spouse|cause_of_death
who is the other half of <e> 's father	isabella_of_france	joan_i_of_navarre	parents|spouse
what is <e> 's father working on	mette_marit_crown_princess_of_norway	journalist	parents|profession
what is the gender of mom of <e>	catharina_of_sweden	male	parents|gender
the gender of <e> 's mother	philippine_elisabeth_of_orleans	male	parents|gender
what sex is <e> 's kid	alexander_ferdinand_3rd_prince_of_thurn_and_taxis	male	children|gender
what is the dad of <e> 's child	gustavus_adolphus_of_sweden	maria_eleonora_of_brandenburg	children|parents
what is the nation of <e> 's children	maria_of_brabant	france	children|nationality
what is the gender of <e> 's offspring	artavasdes_i_of_armenia	male	children|gender
the sex of son of <e>	maximilian_i_of_bavaria	male	children|gender
why <e> 's mom died	penelope_blount_countess_of_devonshire	dysentery	parents|cause_of_death
the place of death of <e> 's mom	william_ii_german_emperor	potsdam	parents|place_of_death
what is the <e> 's darling 's mom	georg_donatus_hereditary_grand_duke_of_hesse	prince_andrew_of_greece_and_denmark	spouse|parents
what is the institution of son of <e>	william_talbot	oriel_college	children|institution
where does <e> 's husband come from	sybil_thomas_viscountess_rhondda	wales|united_kingdom	spouse|nationality
the sex of <e> 's other half	juba_ii	female	spouse|gender
the children of <e> 's offspring	jahangir	dara_shikoh	children|children
what is the <e> 's parents 's sex	princess_sophia_dorothea_of_prussia	male	parents|gender
what is the name of the offspring of <e> 's parent	lady_sarah_wilson	lord_randolph_churchill	parents|children
the sex of wife of <e>	huey_long	female	spouse|gender
what is the <e> 's mom 's institution	rasmus_bartholin	university_of_copenhagen	parents|institution
<e> 's son 's father	mumtaz_mahal	mumtaz_mahal	children|parents
the parents of <e> 's spouse	juliana_maria_of_brunswick_wolfenbuttel	sophia_magdalen_of_brandenburg-kulmbach	spouse|parents
what is the dad of child of <e>	gustavus_adolphus_of_sweden	maria_eleonora_of_brandenburg	children|parents
the nationality of parent of <e>	robert_c_wickliffe	united_states	parents|nationality
<e> 's parents 's gender	artabastos	male	parents|gender
what is the sex of <e> 's couple	lew_cody	female	spouse|gender
who is the spouse of <e> 's husband	mary_anna_custis_lee	mary_anna_custis_lee	spouse|spouse
the work of wife of <e>	ernest_hemingway	journalist	spouse|profession
what is the father of children of <e>	henry_iii_holy_roman_emperor	henry_iii_holy_roman_emperor	children|parents
what is the father of <e> 's children	henry_iii_holy_roman_emperor	henry_iii_holy_roman_emperor	children|parents
who is the child of <e> 's mom	gaston_comte_deu	gaston_comte_deu	parents|children
what is the place of death of mother of <e>	william_kissam_vanderbilt	new_york	parents|place_of_death
what sex is <e> 's wife	james_hepburn_4th_earl_of_bothwell	female	spouse|gender
the wife of <e> 's other half	arleen_whelan	arleen_whelan	spouse|spouse
which institution does <e> 's child work for	victoria_of_the_united_kingdom	trinity_college_cambridge	children|institution
the cause of death of father of <e>	louis_xvi_of_france	tuberculosis	parents|cause_of_death
what is <e> 's child 's ethnicity like	major_ridge	cherokee|native_americans_in_the_united_states	children|ethnicity
what does <e> 's kid do for a living	thomas_thynne_2nd_viscount_weymouth	politician	children|profession
<e> 's dad 's nationality	lynn_redgrave	united_kingdom	parents|nationality
the faith of <e> 's husband	marie-anne_pierrette_paulze	anglicanism	spouse|religion
<e> 's darling 's place of death	elizabeth_allan_1908	new_york	spouse|place_of_death
what is the ethnicity of <e> 's heir	alice_betty_stern	germans	children|ethnicity
what gender is <e> 's parent	thutmose_iv	male	parents|gender
the other half of daughter of <e>	grand_duchess_alexandra_petrovna	anastasia_of_montenegro	children|spouse
the dad of children of <e>	charles_spurgeon	charles_spurgeon	children|parents
what is the name of the heir of <e> 's couple	maria_luisa_of_savoy	mariana_victoria_of_spain	spouse|children
what is the address of couple of <e>	robert_lowell	london	spouse|location
is <e> 's kid a man or a woman	frank_lloyd_wright	male	children|gender
where did <e> 's offspring die	constantine_viii	constantinople	children|place_of_death
the occupation of other half of <e>	ekaterina_svanidze	generalissimo	spouse|profession
what is the nation of <e> 's father	catherine_carey	kingdom_of_england	parents|nationality
what is the heir of parent of <e>	catherine_of_braganza	teodosio_prince_of_brazil	parents|children
the sex of parents of <e>	tyrone_power	male	parents|gender
where does <e> 's son work for	john_b_kelly_sr	american_academy_of_dramatic_arts	children|institution
the sex of parents of <e>	princess_sophia_dorothea_of_prussia	male	parents|gender
what is the cause of death of son of <e>	anton_philips	accidental_fall	children|cause_of_death
what is the name of the husband of <e> 's heir	philip_v_of_spain	joseph_i_of_portugal	children|spouse
is <e> 's child a man or a woman	wang_khan	female	children|gender
what is the kid of <e> 's parents	qianlong_emperor	qianlong_emperor	parents|children
what is the nation of <e> 's parent	edward_of_norwich_2nd_duke_of_york	kingdom_of_england	parents|nationality
what faith does <e> 's son practice	christiane_eberhardine_of_brandenburg_bayreuth	catholicism	children|religion
<e> 's other half 's gender	anne_of_bohemia	male	spouse|gender
the mom of <e> 's mom	stephen_i_of_hungary	taksony_of_hungary	parents|parents
<e> 's mom 's parents	lady_may_abel_smith	princess_helena_duchess_of_albany	parents|parents
the sex of <e> 's husband	henrietta_anne_stuart	male	spouse|gender
what is the nationality of <e> 's dad	titus_van_rijn	netherlands	parents|nationality
the gender of mom of <e>	george_formby	male	parents|gender
what is <e> 's son	marvin_pentz_gay_sr	composer|record_producer	children|profession
what is <e> 's other half	elizabeth_of_york	monarch	spouse|profession
the nation of father of <e>	catherine_carey	kingdom_of_england	parents|nationality
where does <e> 's parent come from	robert_c_wickliffe	united_states	parents|nationality
the nation of parent of <e>	edward_ellice_1810	united_kingdom	parents|nationality
what is the name of the mom of <e> 's mom	stephen_i_of_hungary	taksony_of_hungary	parents|parents
<e> 's darling 's nation	edwin_samuel_montagu	united_kingdom	spouse|nationality
what is the nation of offspring of <e>	sarah_lennox_duchess_of_richmond	united_kingdom	children|nationality
what is the <e> 's offspring 's gender	frederick_iii_german_emperor	female	children|gender
which nationality is <e> 's wife	marie-anne_pierrette_paulze	united_kingdom|germany	spouse|nationality
<e> 's dad 's offspring	william_ii_german_emperor	princess_charlotte_of_prussia	parents|children
the job of children of <e>	jawaharlal_nehru	politician	children|profession
<e> 's spouse 's nationality	margaret_of_artois	france	spouse|nationality
who is the child of <e> 's parent	prince_feodor_alexandrovich_of_russia	prince_andrei_alexandrovich_of_russia	parents|children
is <e> 's dad a man or a woman	lothair_of_france	female	parents|gender
what sex is <e> 's parent	louis_philippe_i_duke_of_orleans	male	parents|gender
what is the cause of death of couple of <e>	john_franklin	tuberculosis	spouse|cause_of_death
what gender is <e> 's spouse	carlos_thompson	female	spouse|gender
<e> 's offspring 's place of death	maria_luisa_of_parma	trieste	children|place_of_death
the gender of wife of <e>	verina	male	spouse|gender
what killed the <e> 's dad	postumus_junior	assassination	parents|cause_of_death
the heir of <e> 's children	wang_khan	mongke_khan	children|children
the job of <e> 's spouse	doris_blackburn	lawyer	spouse|profession
the parents of <e> 's child	anton_philips	anton_philips	children|parents
what is the <e> 's kid 's sex	grand_duke_alexander_mikhailovich_of_russia	male	children|gender
the child of children of <e>	albert_of_saxe-coburg_and_gotha	victoria_eugenia_of_battenberg|prince_maurice_of_battenberg	children|children
what is the <e> 's child 's nationality	geza_i_of_hungary	hungary	children|nationality
what is the <e> 's daughter 's location	louise_defeo	new_york_state	children|location
<e> 's child 's nationality	john_d_rockefeller_jr	united_states	children|nationality
the gender of <e> 's father	yixin_prince_gong	male	parents|gender
the gender of mom of <e>	mieszko_iv_tanglefoot	male	parents|gender
what is the nation of <e> 's offspring	louis_duke_of_nemours	france	children|nationality
what is the heir of <e> 's mother	frits_philips	frits_philips	parents|children
<e> 's parent 's sex	claudius	male	parents|gender
the nationality of dad of <e>	lynn_redgrave	united_kingdom	parents|nationality
what is the <e> 's mother 's gender	philippine_elisabeth_of_orleans	male	parents|gender
is <e> 's couple a man or a woman	phillip_terry	female	spouse|gender
<e> 's mother 's sex	henry_of_portugal	male	parents|gender
where does <e> 's spouse come from	roger_needham	united_kingdom	spouse|nationality
the offspring of parent of <e>	lady_sarah_wilson	lord_randolph_churchill	parents|children
what is <e> 's offspring working on	cosima_wagner	conducting|composer	children|profession
the kid of father of <e>	charles_lennox_2nd_duke_of_richmond	charles_lennox_2nd_duke_of_richmond|anne_van_keppel_countess_of_albemarle	parents|children
<e> 's son 's cause of death	marvin_pentz_gay_sr	firearm	children|cause_of_death
is <e> 's child a man or a woman	jewna	male	children|gender
what is the <e> 's child 's sex	p_j_kennedy	male	children|gender
what is the sex of <e> 's darling	luis_munoz_marin	female	spouse|gender
what is the <e> 's father 's sex	eadgifu_of_england	male	parents|gender
what is the job of father of <e>	elisabeth_of_austria_1526	holy_roman_emperor	parents|profession
the gender of <e> 's darling	roger_needham	female	spouse|gender
what is the name of the mother of <e> 's son	louis_duke_of_nemours	louis_duke_of_nemours	children|parents
what is the <e> 's couple 's cause of death	james_hepburn_4th_earl_of_bothwell	decapitation	spouse|cause_of_death
where does <e> 's spouse work for	colleen_dewhurst	university_of_missouri_columbia	spouse|institution
the cause of death of dad of <e>	justinus_van_nassau	assassination|firearm	parents|cause_of_death
which nationality is <e> 's parents	edward_salisbury_dana	united_states	parents|nationality
what is the nation of <e> 's offspring	sarah_lennox_duchess_of_richmond	united_kingdom	children|nationality
the religious belief of <e> 's father	george_darwin	anglicanism|agnosticism	parents|religion
what sex is <e> 's husband	henrietta_anne_stuart	male	spouse|gender
what is the nation of <e> 's wife	anahareo	canada|united_states	spouse|nationality
how <e> 's child died	adolf_frederick_of_sweden	firearm	children|cause_of_death
what is <e> 's parents	skip_caray	sportscaster	parents|profession
what is the <e> 's dad 's offspring	william_ii_german_emperor	princess_charlotte_of_prussia	parents|children
what is the <e> 's mother 's heir	charles_lennox_2nd_duke_of_richmond	charles_lennox_2nd_duke_of_richmond|anne_van_keppel_countess_of_albemarle	parents|children
what gender is <e> 's husband	cecilia_renata_of_austria	male	spouse|gender
the place of birth of <e> 's wife	adolf_hitler	munich	spouse|place_of_birth
what is the <e> 's son 's cause of death	marvin_pentz_gay_sr	firearm	children|cause_of_death
what is the sex of <e> 's dad	william_ii_german_emperor	male	parents|gender
what is the child of <e> 's mother	archduke_louis_of_austria	rudolf_cardinal_von_habsburg_lothringen|archduke_joseph_of_austria_palatine_of_hungary	parents|children
what does <e> 's husband do for a living	colleen_dewhurst	actor	spouse|profession
what is the child of parent of <e>	thomas_spurgeon	thomas_spurgeon	parents|children
is <e> 's mom a man or a woman	mieszko_iv_tanglefoot	male	parents|gender
how <e> 's wife died	franz_joseph_i_of_austria	assassination	spouse|cause_of_death
what is the profession of <e> 's parents	skip_caray	sportscaster	parents|profession
the place of birth of mom of <e>	anna_e_roosevelt	new_york	parents|place_of_birth
the nationality of kid of <e>	hortense_de_beauharnais	france	children|nationality
where did <e> 's mom born	henry_iii_of_france	florence	parents|place_of_birth
who is the parent of <e> 's son	anna_of_holstein-gottorp	enno_iii_count_of_ostfriesland	children|parents
the cause of death of <e> 's couple	carole_lombard	myocardial_infarction	spouse|cause_of_death
what is <e> 's kid working on	blessed_virgin_mary	carpenter	children|profession
what does <e> 's father do for a living	elisabeth_of_austria_1526	holy_roman_emperor	parents|profession
the gender of couple of <e>	gaius_marius	male	spouse|gender
<e> 's husband 's profession	roger_needham	computer_scientist	spouse|profession
what is the spouse of mom of <e>	henry_i_duke_of_guise	jacques_de_savoie_2nd_duc_de_nemours	parents|spouse
<e> 's offspring 's place of death	augustus_ii_the_strong	avignon	children|place_of_death
is <e> 's child a man or a woman	pierre_curie	female	children|gender
the educational institution of husband of <e>	laura_devon	university_of_notre_dame|university_of_michigan	spouse|institution
<e> 's offspring 's sex	charles_lennox_1st_duke_of_richmond	male|female	children|gender
what is the child of parent of <e>	shah_shuja	shah_shuja	parents|children
what is the cause of death of darling of <e>	mary_anna_custis_lee	pneumonia	spouse|cause_of_death
what faith does <e> 's heir practice	jewna	paganism	children|religion
what is the name of the husband of <e> 's mother	robert_i_duke_of_burgundy	constance_of_arles	parents|spouse
where does <e> 's offspring come from	john_spencer_churchill_7th_duke_of_marlborough	united_kingdom|england	children|nationality
the son of <e> 's mom	john_ii_casimir_of_poland	alexander_charles_vasa	parents|children
what is the nation of <e> 's parent	george_herbert_11th_earl_of_pembroke	united_kingdom	parents|nationality
what is the sex of wife of <e>	mae_west	male	spouse|gender
<e> 's heir 's cause of death	pedro_ii_of_brazil	yellow_fever	children|cause_of_death
what did <e> 's child die from	maria_adelaide_of_austria	tyrannicide	children|cause_of_death
is <e> 's couple a man or a woman	gaius_marius	male	spouse|gender
is <e> 's kid a man or a woman	william_cavendish_bentinck_7th_duke_of_portland	female	children|gender
where is <e> 's other half staying	auguste_van_pels	lower_saxony	spouse|location
what is the <e> 's offspring 's sex	charles_lennox_1st_duke_of_richmond	male|female	children|gender
the place of death of <e> 's kid	princess_beatrice_of_the_united_kingdom	lausanne	children|place_of_death
the location of <e> 's parents	ray_bridwell_white	kentucky	parents|location
what is the father of <e> 's son	mumtaz_mahal	mumtaz_mahal	children|parents
what did <e> 's daughter die from	nicholas_ii_of_russia	murder|firearm	children|cause_of_death
<e> 's mom 's heir	felipe_prospero_of_habsburg	john_of_austria_the_younger	parents|children
<e> 's parent 's child	prince_feodor_alexandrovich_of_russia	prince_andrei_alexandrovich_of_russia	parents|children
what is the <e> 's couple 's gender	maria_luisa_of_savoy	male	spouse|gender
how <e> 's couple died	john_franklin	tuberculosis	spouse|cause_of_death
what is the gender of parents of <e>	lady_louisa_stuart	male	parents|gender
what is the <e> 's kid 's gender	claudine_rhedey_von_kis_rhede	male	children|gender
the nationality of darling of <e>	katherine_corri_harris	united_states	spouse|nationality
where does <e> 's dad work	george_darwin	christs_college_cambridge	parents|institution
<e> 's heir 's nationality	gustaf_vi_adolf_of_sweden	sweden	children|nationality
what is the darling of <e> 's child	sam_marx	susan_fleming	children|spouse
what is the gender of <e> 's parents	buster_keaton	male	parents|gender
the gender of <e> 's other half	grand_duchess_elizabeth_mikhailovna	male	spouse|gender
what sex is <e> 's offspring	adelaide_of_lowenstein_wertheim_rosenberg	female	children|gender
what is the ethnicity of <e> 's darling	george_tabori	swedish_american|swedish_people	spouse|ethnicity
where does <e> 's son work for	william_talbot	oriel_college	children|institution
the work of kid of <e>	emperor_temmu	writer	children|profession
where did <e> 's daughter die	anne_marie_martinozzi	fontainebleau	children|place_of_death
the gender of <e> 's couple	pearl_bailey	male	spouse|gender
what is the sex of daughter of <e>	william_of_winchester_lord_of_lunenburg	male	children|gender
what is the gender of couple of <e>	phillip_terry	female	spouse|gender
what is the gender of other half of <e>	benjamin_harrison	female	spouse|gender
what is the <e> 's other half 's sex	harry_hay	male	spouse|gender
what is the <e> 's parent 's nation	john_i_of_denmark	germany	parents|nationality
what type of religion does <e> 's dad have	j_p_morgan_jr	anglicanism	parents|religion
what is the sex of child of <e>	wang_khan	female	children|gender
what is the <e> 's heir 's sex	marie_antoinette	female	children|gender
what is the gender of father of <e>	mikolaj_vii_radziwill	female	parents|gender
what is the mom of parents of <e>	princess_amelia_sophia_of_great_britain	george_i_of_great_britain	parents|parents
the nationality of <e> 's other half	hermann_einstein	germany	spouse|nationality
what is the nation of mother of <e>	alexander_ii_of_russia	germany	parents|nationality
<e> 's dad 's daughter	princess_sophia_dorothea_of_prussia	frederick_ii_of_prussia	parents|children
what is the dad of children of <e>	charles_spurgeon	charles_spurgeon	children|parents
what is the <e> 's mom 's heir	felipe_prospero_of_habsburg	john_of_austria_the_younger	parents|children
what is the couple of <e> 's mom	sunandha	mongkut	parents|spouse
what is the <e> 's parents 's place of death	princess_margaret_of_prussia	potsdam	parents|place_of_death
what does <e> 's daughter do for a living	john_a_roebling	engineer	children|profession
the sex of <e> 's children	aurangzeb	male	children|gender
what is the nation of <e> 's son	princess_beatrice_of_the_united_kingdom	united_kingdom	children|nationality
what made the <e> 's coupledead	anahareo	pneumonia	spouse|cause_of_death
who is the child of <e> 's son	duke_peter_of_oldenburg	grand_duke_peter_nicolaievich_of_russia|grand_duke_nicholas_nicolaevich_the_younger	children|children
the nation of <e> 's mother	princess_elizabeth_of_england	kingdom_of_france	parents|nationality
<e> 's mom 's place of death	mihailo_obrenovic_iii_prince_of_serbia	belgrade	parents|place_of_death
the gender of <e> 's darling	elizabeth_macquarie	male	spouse|gender
what is the <e> 's daughter 's race	marvin_pentz_gay_sr	african_american	children|ethnicity
<e> 's mother 's heir	diego_colon	fernando_colon	parents|children
what city did <e> 's offspring die	constantine_viii	constantinople	children|place_of_death
where did <e> 's father die	titus_van_rijn	amsterdam	parents|place_of_death
<e> 's parents 's gender	alfonso_iv_of_leon	male	parents|gender
what is the <e> 's parent 's nationality	frederika_of_hanover	germany	parents|nationality
what is the <e> 's daughter 's children	francis_iv_duke_of_modena	carlos_duke_of_madrid	children|children
who is the daughter of <e> 's kid	marguerite_of_france	elizabeth_of_rhuddlan	children|children
the gender of <e> 's couple	ruth_roland	male	spouse|gender
the nation of spouse of <e>	bettye_ackerman	united_states	spouse|nationality
what line of business is <e> 's parents in	j_p_morgan_jr	financier	parents|profession
what gender is <e> 's child	barbu_stirbey	male	children|gender
who is the kid of <e> 's father	charles_lennox_2nd_duke_of_richmond	charles_lennox_2nd_duke_of_richmond|anne_van_keppel_countess_of_albemarle	parents|children
what is the dad of <e> 's mother	henry_i_duke_of_guise	renee_of_france	parents|parents
what faith does <e> 's heir have	jewna	paganism	children|religion
how <e> 's father died	louise_juliana_of_nassau	assassination|firearm	parents|cause_of_death
what is the nationality of dad of <e>	lynn_redgrave	united_kingdom	parents|nationality
what does <e> 's children do for a living	william_talbot	politician|lawyer	children|profession
the organization of spouse of <e>	colleen_dewhurst	university_of_missouri_columbia	spouse|institution
which nationality is <e> 's couple	frederica_of_mecklenburg-strelitz	united_kingdom	spouse|nationality
what is the name of the mother of <e> 's parents	christian_ii_of_denmark	dorothea_of_brandenburg	parents|parents
what does <e> 's children do	jawaharlal_nehru	politician	children|profession
<e> 's daughter 's sex	qianlong_emperor	male	children|gender
what is the nation of mom of <e>	henry_howard_7th_duke_of_norfolk	kingdom_of_england|england	parents|nationality
is <e> 's children a man or a woman	michael_i_rangabe	male	children|gender
which nationality is <e> 's children	william_backhouse_astor_jr	united_states	children|nationality
what is the kid of <e> 's father	princess_tenagnework	princess_tsehai	parents|children
what is the <e> 's wife 's other half	henry_vii_of_england	henry_vii_of_england	spouse|spouse
what is the <e> 's mom 's gender	regina_crown_princess_of_austria	male	parents|gender
what is the educational institution of <e> 's child	benjamin_peirce	harvard_university	children|institution
<e> 's father 's sex	frederick_v_of_denmark	female	parents|gender
what is the nationality of <e> 's mother	marie_francois_sadi_carnot	france	parents|nationality
what is <e> 's spouse	richard_mulligan	actor	spouse|profession
what killed the <e> 's couple	james_hepburn_4th_earl_of_bothwell	decapitation	spouse|cause_of_death
where does <e> 's mother come from	alexander_ii_of_russia	germany	parents|nationality
<e> 's parent 's cause of death	anna_e_roosevelt	tuberculosis	parents|cause_of_death
how <e> 's other half died	caesonia	tyrannicide	spouse|cause_of_death
what is the place of birth of dad of <e>	rudolf_christian_count_of_ostfriesland	aurich	parents|place_of_birth
what made the <e> 's fatherdead	louise_juliana_of_nassau	assassination|firearm	parents|cause_of_death
what is the nation of mother of <e>	henry_howard_7th_duke_of_norfolk	kingdom_of_england|england	parents|nationality
what religious belief does <e> 's mother practice	charles_ferdinand_duc_de_berry	catholicism	parents|religion
<e> 's parents 's educational institution	edward_salisbury_dana	yale_university	parents|institution
what is the gender of kid of <e>	sarah_lennox_duchess_of_richmond	male	children|gender
what is the work of other half of <e>	doris_dowling	composer	spouse|profession
the nation of mother of <e>	princess_elizabeth_of_england	kingdom_of_france	parents|nationality
what is the father of wife of <e>	aelia_eudoxia	theodosius_i	spouse|parents
what is the nationality of child of <e>	grand_duke_michael_mihailovich_of_russia	united_kingdom	children|nationality
who is the grandparent of <e>	william_kissam_vanderbilt	cornelius_vanderbilt	parents|parents
what is the <e> 's parents 's child	anne_of_cleves	sybille_of_cleves	parents|children
what is the sex of <e> 's spouse	mary_stuart_countess_of_bute	male	spouse|gender
what is the name of the child of <e> 's children	albert_of_saxe-coburg_and_gotha	victoria_eugenia_of_battenberg|prince_maurice_of_battenberg	children|children
the gender of child of <e>	henry_iii_holy_roman_emperor	male	children|gender
what is the name of the parents of <e> 's mom	louis_philippe_i_duke_of_orleans	francoise_marie_de_bourbon	parents|parents
the mom of <e> 's daughter	osorkon_iii	osorkon_iii	children|parents
what is the <e> 's parents 's sex	otto_i_duke_of_saxony	male	parents|gender
<e> 's parent 's daughter	takelot_iii	takelot_iii	parents|children
what is the organization of mom of <e>	prince_joachim_of_prussia	university_of_bonn	parents|institution
the nation of son of <e>	johann_bernoulli	netherlands	children|nationality
what is the <e> 's parent 's nationality	robert_c_wickliffe	united_states	parents|nationality
what is the <e> 's mom 's offspring	tasha_tudor	tasha_tudor	parents|children
who is the heir of <e> 's children	wang_khan	mongke_khan	children|children
what is the <e> 's father 's gender	princess_tenagnework	male	parents|gender
is <e> 's dad a man or a woman	boleslaw_ii_of_poland	male	parents|gender
where did the parents of <e> die	louis_xvi_of_france	chateau_de_fontainebleau	parents|place_of_death
where does <e> 's parent work for	tasha_tudor	harvard_university	parents|institution
the heir of <e> 's other half	henriette_adelaide_of_savoy	joseph_clemens_of_bavaria	spouse|children
<e> 's wife 's ethnicity	carlos_thompson	germans	spouse|ethnicity
<e> 's darling 's cause of death	mary_anna_custis_lee	pneumonia	spouse|cause_of_death
which nationality is <e> 's son	pierre_curie	france	children|nationality
where is <e> 's mother staying	peter_van_pels	lower_saxony	parents|location
what does <e> 's kid do for a living	john_hays_hammond	inventor	children|profession
what faith does <e> 's child follow	george_of_saxony	roman_catholic_church	children|religion
is <e> 's child a man or a woman	john_iv_of_portugal	male	children|gender
<e> 's wife 's nationality	marie-anne_pierrette_paulze	united_kingdom|germany	spouse|nationality
the organization of <e> 's son	john_b_kelly_sr	american_academy_of_dramatic_arts	children|institution
who is the offspring of <e> 's dad	clodoald	clodoald	parents|children
what is the <e> 's darling 's nationality	katherine_corri_harris	united_states	spouse|nationality
what is the sex of <e> 's kid	chindasuinth	male	children|gender
<e> 's couple 's gender	empress_xiaomu	male	spouse|gender
the husband of <e> 's son	marie_of_edinburgh	archduke_anton_prince_of_tuscany	children|spouse
what is the gender of <e> 's darling	benjamin_disraeli_1st_earl_of_beaconsfield	female	spouse|gender
what is the organization of <e> 's parent	john_f_kennedy_jr	riverdale_country_school|london_school_of_economics	parents|institution
the nation of offspring of <e>	john_spencer_churchill_7th_duke_of_marlborough	united_kingdom|england	children|nationality
the cause of death of mom of <e>	caligula	assassination	parents|cause_of_death
<e> 's husband 's sex	john_of_gaunt_1st_duke_of_lancaster	female	spouse|gender
what is the faith of father of <e>	victor_amadeus_iii_of_sardinia	catholicism	parents|religion
what is the <e> 's couple 's sex	lew_cody	female	spouse|gender
<e> 's wife 's gender	verina	male	spouse|gender
what is the sex of dad of <e>	robert_i_duke_of_burgundy	male	parents|gender
what line of business is <e> 's heir in	henry_iv_of_england	monarch	children|profession
where does <e> 's spouse work for	virginia_heinlein	united_states_naval_academy	spouse|institution
<e> 's offspring 's cause of death	archduke_carl_ludwig_of_austria	firearm	children|cause_of_death
where is <e> 's heir living	hermann_einstein	italy	children|location
what is the darling of <e> 's husband	robert_e_lee	robert_e_lee	spouse|spouse
what killed the <e> 's couple	madhubala	cardiovascular_disease	spouse|cause_of_death
please tell me <e> 's children present address	augusta_viktoria_of_schleswig-holstein	potsdam	children|location
what is the race of father of <e>	princess_tenagnework	oromo	parents|ethnicity
the darling of <e> 's child	sam_marx	susan_fleming	children|spouse
what is the <e> 's spouse 's gender	ptolemy_ix_lathyros	female	spouse|gender
what is the other half of <e> 's other half	alexander_darcy	alexander_darcy	spouse|spouse
<e> 's husband 's gender	james_cruze	female	spouse|gender
what is the nationality of darling of <e>	lew_cody	united_states	spouse|nationality
what is the <e> 's dad 's daughter	princess_sophia_dorothea_of_prussia	frederick_ii_of_prussia	parents|children
what is the organization of father of <e>	lady_louisa_stuart	eton_college	parents|institution
what is the <e> 's other half 's type of religion	mariana_victoria_of_spain	catholicism	spouse|religion
the gender of <e> 's parents	buster_keaton	male	parents|gender
what is the gender of <e> 's son	charles_ii_of_austria	female	children|gender
is <e> 's parents a man or a woman	andrey_bolshoy	male	parents|gender
what is the <e> 's dad 's faith	john_ii_casimir_of_poland	catholicism	parents|religion
what is the <e> 's wife 's nation	vilhelmine_marie_of_denmark	denmark	spouse|nationality
the sex of darling of <e>	colleen_dewhurst	male	spouse|gender
the religion of <e> 's wife	infante_fernando_duke_of_viseu	roman_catholic_church	spouse|religion
what gender is <e> 's kid	marie_of_edinburgh	male	children|gender
is <e> 's other half a man or a woman	anna_radziwill	male	spouse|gender
the gender of children of <e>	princess_beatrice_of_the_united_kingdom	male	children|gender
which city did <e> 's mother born	marguerite_of_france	leuven	parents|place_of_birth
<e> 's darling 's nation	margaret_mead	united_states	spouse|nationality
what is the <e> 's kid 's gender	alexandre_vicomte_de_beauharnais	female	children|gender
what is the profession of <e> 's child	gheorghe_i_tasca	politician	children|profession
what is the <e> 's parents 's gender	lady_louisa_stuart	male	parents|gender
what is the gender of <e> 's mother	pearl_starr	female	parents|gender
<e> 's parents 's daughter	infante_joao_of_portugal	infanta_isabel_duchess_of_burgundy	parents|children
<e> 's wife 's profession	alexander_darcy	actor	spouse|profession
the gender of <e> 's parent	princess_margaret_of_prussia	male	parents|gender
what is <e> 's spouse 's race like	elizabeth_de_burgh	scottish_people	spouse|ethnicity
the darling of <e> 's darling	arcadius	arcadius	spouse|spouse
who is the grandheir of <e>	jodhabai	shah_jahan	children|children
who is the child of <e> 's parent	shah_shuja	shah_shuja	parents|children
which nationality is <e> 's darling	alva_belmont	united_states	spouse|nationality
what is the work of other half of <e>	elizabeth_of_york	monarch	spouse|profession
what is the ethnicity of <e> 's couple	george_tabori	swedish_american|swedish_people	spouse|ethnicity
the nation of children of <e>	james_otis_sr	united_states	children|nationality
the place of death of offspring of <e>	maria_theresa_of_austria	vienna	children|place_of_death
what is the cause of death of <e> 's dad	isabella_of_france	animal_attack	parents|cause_of_death
is <e> 's parents a man or a woman	artabastos	male	parents|gender
what is the child of children of <e>	albert_of_saxe-coburg_and_gotha	victoria_eugenia_of_battenberg|prince_maurice_of_battenberg	children|children
what is the sex of <e> 's mother	henry_of_portugal	male	parents|gender
what is the <e> 's mother 's place of birth	marguerite_of_france	leuven	parents|place_of_birth
what is the mother of parents of <e>	christian_ii_of_denmark	dorothea_of_brandenburg	parents|parents
where does <e> 's darling come from	margaret_mead	united_states	spouse|nationality
<e> 's spouse 's place of birth	katherine_corri_harris	philadelphia	spouse|place_of_birth
<e> 's kid 's couple	elena_pavlovna_of_wurttemberg	adolphe_grand_duke_of_luxembourg	children|spouse
the place of death of <e> 's mother	william_kissam_vanderbilt	new_york	parents|place_of_death
the sex of child of <e>	jewna	male	children|gender
who is the heir of <e> 's child	jodhabai	shah_jahan	children|children
what is the cause of death of mom of <e>	penelope_blount_countess_of_devonshire	dysentery	parents|cause_of_death
what did <e> 's dad die from	isabella_of_france	animal_attack	parents|cause_of_death
<e> 's heir 's gender	jahangir	male	children|gender
why <e> 's mother died	skip_caray	cardiovascular_disease	parents|cause_of_death
how <e> 's kid died	john_d_rockefeller_jr	myocardial_infarction	children|cause_of_death
the occupation of <e> 's heir	henry_iv_of_england	monarch	children|profession
<e> 's husband 's organization	julie_london	wharton_school_of_the_university_of_pennsylvania	spouse|institution
what is the sex of darling of <e>	ronald_reagan	female	spouse|gender
where does <e> 's wife come from	robert_anderson_1917	united_states	spouse|nationality
the parents of <e> 's mom	lady_may_abel_smith	princess_helena_duchess_of_albany	parents|parents
what is the gender of kid of <e>	claudine_rhedey_von_kis_rhede	male	children|gender
what is the sex of <e> 's father	eadgifu_of_england	male	parents|gender
what is the darling of children of <e>	james_ii_of_england	george_of_denmark	children|spouse
what is the sex of offspring of <e>	charles_lennox_1st_duke_of_richmond	male|female	children|gender
the place of death of mom of <e>	william_ii_german_emperor	potsdam	parents|place_of_death
the nationality of spouse of <e>	peter_sellers	england	spouse|nationality
<e> 's other half 's sex	harry_hay	male	spouse|gender
what is the place of death of son of <e>	francis_i_of_france	paris	children|place_of_death
the nationality of <e> 's mom	george_formby	england	parents|nationality
which nationality is <e> 's child	leonard_jerome	united_states	children|nationality
what is the son of husband of <e>	caroline_webster_schermerhorn_astor	john_jacob_astor_iv	spouse|children
the nation of offspring of <e>	grand_duchess_alexandra_petrovna	russia	children|nationality
what is the <e> 's mom 's organization	prince_joachim_of_prussia	university_of_bonn	parents|institution
what is the work of <e> 's children	j_presper_eckert	electrical_engineer	children|profession
the other half of father of <e>	isabella_of_france	joan_i_of_navarre	parents|spouse
what is the <e> 's wife 's cause of death	franz_joseph_i_of_austria	assassination	spouse|cause_of_death
the gender of <e> 's other half	anne_of_bohemia	male	spouse|gender
what is the name of the offspring of <e> 's mom	tasha_tudor	tasha_tudor	parents|children
the nationality of kid of <e>	mary_de_bohun	england	children|nationality
what is the <e> 's darling 's wife	marjorie_merriweather_post	marjorie_merriweather_post	spouse|spouse
the child of <e> 's parents	anne_of_cleves	sybille_of_cleves	parents|children
what is the name of the spouse of <e> 's husband	aelia_eudoxia	aelia_eudoxia	spouse|spouse
<e> 's parent 's offspring	lady_sarah_wilson	lord_randolph_churchill	parents|children
the profession of husband of <e>	harry_hay	inventor	spouse|profession
what is the place of death of <e> 's darling	elizabeth_allan_1908	new_york	spouse|place_of_death
what is the <e> 's parent 's sex	claudius	male	parents|gender
what gender is <e> 's heir	charles_i_of_england	female	children|gender
<e> 's other half 's nationality	caroline_benn	united_kingdom	spouse|nationality
what is the religion of <e> 's wife	mary_josephine_hannon_fitzgerald	catholicism	spouse|religion
what is the gender of darling of <e>	empress_xiaoquan_cheng	male	spouse|gender
what ethnicity is <e> 's wife	noble_consort_wan	manchu	spouse|ethnicity
who is the parent of <e> 's son	augusta_of_saxe-weimar	william_i_german_emperor	children|parents
what is the nationality of <e> 's son	pierre_curie	france	children|nationality
the gender of <e> 's darling	louise_juliana_of_nassau	male	spouse|gender
what is the dad of <e> 's kid	chlodomer	chlodomer	children|parents
the place of birth of <e> 's wife	alice_of_bourbon_parma	florence	spouse|place_of_birth
the place of birth of <e> 's heir	jawaharlal_nehru	allahabad	children|place_of_birth
what is the couple of <e> 's kid	alice_spencer	henry_hastings_5th_earl_of_huntingdon	children|spouse
the profession of <e> 's kid	sigurd_ibsen	film_director|screenwriter	children|profession
<e> 's daughter 's heir	victoria_kinoiki_kekaulike	abigail_kapiolani_kawananakoa	children|children
what is the nation of <e> 's offspring	grand_duchess_alexandra_petrovna	russia	children|nationality
what is the sex of <e> 's dad	sviatoslav_ii_of_kiev	male	parents|gender
is <e> 's darling a man or a woman	samuel_gridley_howe	male|female	spouse|gender
the nation of parent of <e>	john_i_of_denmark	germany	parents|nationality
the location of parent of <e>	george_darwin	shrewsbury	parents|location
the gender of couple of <e>	yaroslav_i_the_wise	male	spouse|gender
what is the gender of <e> 's children	louis_ix_of_france	male	children|gender
what gender is <e> 's parents	natalia_alexeievna_of_russia	female	parents|gender
the place of birth of <e> 's children	pierre_curie	paris	children|place_of_birth
where does <e> 's wife come from	sybil_thomas_viscountess_rhondda	wales|united_kingdom	spouse|nationality
what gender is <e> 's kid	anton_philips	male	children|gender
where does <e> 's son work	william_talbot	oriel_college	children|institution
what is the <e> 's child 's sex	pierre_curie	female	children|gender
what does <e> 's daughter do	alexandra_fyodorovna_of_hesse	grand_duchess	children|profession
<e> 's father 's institution	thomas_lamb_eliot	harvard_divinity_school	parents|institution
<e> 's darling 's sex	albert_vii_archduke_of_austria	female	spouse|gender
what is the <e> 's mom 's ethnicity	cleopatra_selene	greeks_in_egypt	parents|ethnicity
<e> 's couple 's mother	victor_emmanuel_iii_of_italy	nicholas_i_of_montenegro	spouse|parents
what is the gender of father of <e>	yixin_prince_gong	male	parents|gender
what did <e> 's mother die from	skip_caray	cardiovascular_disease	parents|cause_of_death
what is the job of <e> 's son	marvin_pentz_gay_sr	composer|record_producer	children|profession
what is the <e> 's mom 's child	grand_duke_george_mikhailovich_of_russia	grand_duke_alexei_mikhailovich_of_russia	parents|children
<e> 's children 's children	tiberius_nero	julius_caesar_drusus	children|children
what faith does <e> 's son have	christiane_eberhardine_of_brandenburg_bayreuth	catholicism	children|religion
<e> 's dad 's sex	william_ii_german_emperor	male	parents|gender
the educational institution of dad of <e>	george_darwin	christs_college_cambridge	parents|institution
what is the parents of parents of <e>	princess_sophia_dorothea_of_prussia	sophia_dorothea_of_celle	parents|parents
what does <e> 's kid do for a living	hermann_einstein	physician	children|profession
what gender is <e> 's parents	buster_keaton	male	parents|gender
what is the gender of dad of <e>	frederick_edward_guest	male	parents|gender
what sex is <e> 's other half	georg_donatus_hereditary_grand_duke_of_hesse	female	spouse|gender
the couple of <e> 's couple	julie_london	julie_london	spouse|spouse
what is the name of the wife of <e> 's heir	maria_of_spain	infanta_isabella_clara_eugenia_of_spain	children|spouse
what line of business is <e> 's son in	nathan_mayer_rothschild	politician	children|profession
how <e> 's couple died	anahareo	pneumonia	spouse|cause_of_death
<e> 's child 's nationality	geza_i_of_hungary	hungary	children|nationality
what does <e> 's father do for a living	george_grossmith_jr	novelist|singer	parents|profession
what killed the <e> 's father	louise_juliana_of_nassau	assassination|firearm	parents|cause_of_death
what is the darling of husband of <e>	robert_e_lee	robert_e_lee	spouse|spouse
the nation of <e> 's couple	frederica_of_mecklenburg-strelitz	united_kingdom	spouse|nationality
what is the name of the mom of <e> 's daughter	osorkon_iii	osorkon_iii	children|parents
the gender of <e> 's daughter	joseph_p_kennedy_sr	female	children|gender
the place of birth of <e> 's mother	marguerite_of_france	leuven	parents|place_of_birth
<e> 's kid 's sex	christian_x_of_denmark	male	children|gender
what faith does <e> 's father practice	victor_amadeus_iii_of_sardinia	catholicism	parents|religion
what is the <e> 's husband 's cause of death	evelyn_keyes	diabetes_mellitus	spouse|cause_of_death
what is the nation of <e> 's couple	julie_london	united_states	spouse|nationality
what is the work of <e> 's kid	john_hays_hammond	inventor	children|profession
the daughter of <e> 's child	archduke_carl_ludwig_of_austria	prince_ernst_von_hohenberg	children|children
what is <e> 's spouse	evelyn_keyes	composer	spouse|profession
what is the organization of <e> 's spouse	colleen_dewhurst	university_of_missouri_columbia	spouse|institution
the sex of child of <e>	pierre_curie	female	children|gender
the place of death of <e> 's daughter	george_iii_of_the_united_kingdom	windsor_castle	children|place_of_death
what faith does <e> 's dad have	john_ii_casimir_of_poland	catholicism	parents|religion
the gender of darling of <e>	andronikos_iii_palaiologos	female	spouse|gender
what is the <e> 's offspring 's place of death	maria_theresa_of_austria	vienna	children|place_of_death
<e> 's child 's sex	david_kawananakoa	female	children|gender
what is the <e> 's child 's ethnicity	yongzheng_emperor	manchu	children|ethnicity
what is the nation of children of <e>	frank_lloyd_wright	united_states	children|nationality
is <e> 's dad a man or a woman	sviatoslav_ii_of_kiev	male	parents|gender
what is the <e> 's spouse 's parents	alva_belmont	william_henry_vanderbilt	spouse|parents
what is the sex of mother of <e>	augustus_keppel_1st_viscount_keppel	male	parents|gender
what is the <e> 's husband 's profession	harry_hay	inventor	spouse|profession
the gender of <e> 's spouse	carlos_thompson	female	spouse|gender
what is the gender of <e> 's daughter	alice_betty_stern	male	children|gender
the nation of <e> 's offspring	louis_duke_of_nemours	france	children|nationality
what is the gender of <e> 's kid	louis_xvi_of_france	female	children|gender
<e> 's dad 's sex	constantine_xi	male	parents|gender
where does <e> 's other half come from	anahareo	canada|united_states	spouse|nationality
what is the heir of <e> 's daughter	christiane_eberhardine_of_brandenburg_bayreuth	marie_josephe_of_saxony	children|children
what is the <e> 's children 's gender	prince_alexander_of_hesse_and_by_rhine	male	children|gender
<e> 's wife 's type of religion	james_hepburn_4th_earl_of_bothwell	catholicism	spouse|religion
the place of birth of spouse of <e>	victor_emmanuel_iii_of_italy	cetinje	spouse|place_of_birth
what is the husband of <e> 's son	marie_of_edinburgh	archduke_anton_prince_of_tuscany	children|spouse
is <e> 's darling a man or a woman	lovisa_of_sweden	male	spouse|gender
<e> 's other half 's father	infanta_maria_de_la_paz_of_spain	infanta_amelia_philippina_of_spain	spouse|parents
<e> 's parent 's religious belief	thomas_spurgeon	christian	parents|religion
<e> 's offspring 's son	chulalongkorn	nakkhatra_mangkala_kitiyakara	children|children
what is the place of death of son of <e>	maria_fyodorovna_of_russia	vienna	children|place_of_death
the educational institution of <e> 's parents	edward_salisbury_dana	yale_university	parents|institution
what is the address of heir of <e>	hermann_einstein	italy	children|location
what is the son of <e> 's kid	alexandre_vicomte_de_beauharnais	napoleon_iii_of_france	children|children
the gender of parent of <e>	princess_margaret_of_prussia	male	parents|gender
what type of religion is <e> 's other half	mariana_victoria_of_spain	catholicism	spouse|religion
<e> 's kid 's gender	henrietta_anne_stuart	female	children|gender
why <e> 's couple died	john_franklin	tuberculosis	spouse|cause_of_death
what is the gender of <e> 's husband	cecilia_renata_of_austria	male	spouse|gender
what is the gender of <e> 's couple	yaroslav_i_the_wise	male	spouse|gender
where does <e> 's father work	thomas_lamb_eliot	harvard_divinity_school	parents|institution
what city did <e> 's offspring die	archduchess_maria_beatrix_of_austria_este	varese	children|place_of_death
what sex is <e> 's heir	mutemwiya_wife_of_thutmose_iv	male	children|gender
who is the son of <e> 's offspring	chulalongkorn	nakkhatra_mangkala_kitiyakara	children|children
what is the gender of darling of <e>	louise_juliana_of_nassau	male	spouse|gender
the nation of <e> 's daughter	roy_thomson_1st_baron_thomson_of_fleet	canada	children|nationality
the wife of <e> 's dad	henry_ii_of_england	henry_v_holy_roman_emperor	parents|spouse
what is the <e> 's spouse 's daughter	noble_consort_wan	jiaqing_emperor	spouse|children
what is the nation of daughter of <e>	nathan_mayer_rothschild	united_kingdom	children|nationality
where did the father of <e> die	roy_e_disney	burbank	parents|place_of_death
what killed the <e> 's father	george_darwin	coronary_thrombosis	parents|cause_of_death
what gender is <e> 's darling	andronikos_iii_palaiologos	female	spouse|gender
<e> 's kid 's nation	louise_of_mecklenburg-strelitz	germany	children|nationality
the son of father of <e>	charles_duke_of_lower_lorraine	lothair_of_france	parents|children
what is the <e> 's son 's mother	grand_duke_konstantin_nikolayevich_of_russia	alexandra_iosifovna_of_altenburg	children|parents
what does <e> 's father do	george_grossmith_jr	novelist|singer	parents|profession
the ethnicity of <e> 's wife	carlos_thompson	germans	spouse|ethnicity
what is <e> 's parent working on	ethel_lilian_voynich	mathematician	parents|profession
what is the <e> 's dad 's kid	henry_iv_holy_roman_emperor	henry_iv_holy_roman_emperor	parents|children
the parents of spouse of <e>	juliana_maria_of_brunswick_wolfenbuttel	sophia_magdalen_of_brandenburg-kulmbach	spouse|parents
what is the nation of <e> 's wife	robert_anderson_1917	united_states	spouse|nationality
where does <e> 's parent come from	frederika_of_hanover	germany	parents|nationality
is <e> 's daughter a man or a woman	alice_betty_stern	male	children|gender
what killed the <e> 's darling	ida_lupino	lung_cancer	spouse|cause_of_death
what is the cause of death of <e> 's darling	mary_anna_custis_lee	pneumonia	spouse|cause_of_death
what is the <e> 's dad 's sex	robert_i_duke_of_burgundy	male	parents|gender
what is the name of the heir of <e> 's mother	charles_lennox_2nd_duke_of_richmond	charles_lennox_2nd_duke_of_richmond|anne_van_keppel_countess_of_albemarle	parents|children
which nationality is <e> 's parents	lady_louisa_stuart	scotland	parents|nationality
where does <e> 's offspring come from	henry_of_scotland_3rd_earl_of_huntingdon	kingdom_of_scotland	children|nationality
the heir of <e> 's mother	marguerite_of_france	louis_devreux	parents|children
what is the <e> 's daughter 's nation	roy_thomson_1st_baron_thomson_of_fleet	canada	children|nationality
what is the <e> 's heir 's ethnicity	alice_betty_stern	germans	children|ethnicity
what is the <e> 's kid 's gender	sarah_lennox_duchess_of_richmond	male	children|gender
where did the daughter of <e> die	henry_stanton	greenwich_connecticut	children|place_of_death
the place of death of <e> 's child	cheryl_crowe	escondido	children|place_of_death
what is the <e> 's kid 's work	blessed_virgin_mary	carpenter	children|profession
is <e> 's offspring a man or a woman	gustavus_adolphus_of_sweden	female	children|gender
what is the faith of <e> 's dad	john_ii_casimir_of_poland	catholicism	parents|religion
who is the heir of <e> 's mother	charles_lennox_2nd_duke_of_richmond	charles_lennox_2nd_duke_of_richmond|anne_van_keppel_countess_of_albemarle	parents|children
what is the sex of parents of <e>	ludwig_ii_of_bavaria	male	parents|gender
is <e> 's husband a man or a woman	grand_duke_peter_nicolaievich_of_russia	female	spouse|gender
the nationality of mom of <e>	diego_colon	italy	parents|nationality
what is the father of <e> 's child	yongzheng_emperor	yongzheng_emperor	children|parents
the cause of death of daughter of <e>	james_otis_sr	lightning	children|cause_of_death
who is the mother of <e> 's parents	marguerite_of_france	henry_iii_duke_of_brabant	parents|parents
what is the father of <e> 's kid	charles_a_wickliffe	charles_a_wickliffe	children|parents
what is the <e> 's children 's gender	louis_ix_of_france	male	children|gender
<e> 's parents 's nationality	claudius	roman_empire	parents|nationality
the sex of heir of <e>	sylvia_likens	male	children|gender
is <e> 's darling a man or a woman	joseph_e_davies	female	spouse|gender
the sex of child of <e>	svante_nilsson	male	children|gender
the heir of <e> 's mother	diego_colon	fernando_colon	parents|children
the son of parent of <e>	robert_c_wickliffe	robert_c_wickliffe	parents|children
the cause of death of <e> 's son	marvin_pentz_gay_sr	firearm	children|cause_of_death
what is the mom of <e> 's daughter	osorkon_iii	osorkon_iii	children|parents
<e> 's offspring 's faith	hermann_einstein	jew	children|religion
what is the <e> 's child 's daughter	archduke_carl_ludwig_of_austria	prince_ernst_von_hohenberg	children|children
the race of parent of <e>	simeon_uro	serbs	parents|ethnicity
what city did <e> 's darling die	anna_lee	santa_barbara	spouse|place_of_death
who is the darling of <e> 's other half	joseph_e_davies	joseph_e_davies	spouse|spouse
what is the cause of death of heir of <e>	pedro_ii_of_brazil	yellow_fever	children|cause_of_death
what is the job of <e> 's kid	hermann_einstein	physician	children|profession
what is the name of the darling of <e> 's other half	joseph_e_davies	joseph_e_davies	spouse|spouse
the son of father of <e>	maria_antonia_of_portugal	maria_josepha_of_portugal	parents|children
the educational institution of parents of <e>	edward_salisbury_dana	yale_university	parents|institution
<e> 's kid 's nationality	mary_de_bohun	england	children|nationality
what is the nation of wife of <e>	anahareo	canada|united_states	spouse|nationality
what is the nation of <e> 's parent	pearl_starr	united_states	parents|nationality
what is the son of <e> 's parents	niels_bohr	harald_bohr	parents|children
which organization does <e> 's parent work for	john_f_kennedy_jr	riverdale_country_school|london_school_of_economics	parents|institution
what is the cause of death of other half of <e>	adolf_hitler	suicide|cyanide_poisoning	spouse|cause_of_death
where does <e> 's darling come from	katherine_corri_harris	united_states	spouse|nationality
where does <e> 's child work	benjamin_peirce	harvard_university	children|institution
what is the son of <e> 's kid	leopold_grand_duke_of_baden	grand_duke_alexei_mikhailovich_of_russia	children|children
what is the sex of spouse of <e>	mary_stuart_countess_of_bute	male	spouse|gender
who is the daughter of <e> 's parent	elisabeth_of_austria_1526	maria_of_habsburg_archduchess_of_austria	parents|children
what is the gender of child of <e>	grand_duke_michael_mihailovich_of_russia	female	children|gender
what sex is <e> 's dad	william_ii_german_emperor	male	parents|gender
<e> 's couple 's sex	chilperic_i	female	spouse|gender
the gender of child of <e>	barbu_stirbey	male	children|gender
what gender is <e> 's husband	james_cruze	female	spouse|gender
what is the gender of <e> 's darling	richard_mulligan	female	spouse|gender
the sex of <e> 's wife	laura_borden	male	spouse|gender
what is the sex of <e> 's child	p_j_kennedy	male	children|gender
where does <e> 's parent come from	pearl_starr	united_states	parents|nationality
what is the gender of parents of <e>	lord_robert_manners	male	parents|gender
the sex of child of <e>	david_kawananakoa	female	children|gender
is <e> 's wife a man or a woman	princess_ileana_of_romania	male	spouse|gender
<e> 's offspring 's place of death	archduchess_maria_beatrix_of_austria_este	varese	children|place_of_death
what is the nationality of dad of <e>	niels_bohr	denmark	parents|nationality
the gender of <e> 's mom	thomas_lamb_eliot	male	parents|gender
<e> 's darling 's gender	franz_joseph_i_of_austria	female	spouse|gender
where is <e> 's mother living	peter_van_pels	lower_saxony	parents|location
what is the name of the child of <e> 's child	albert_of_saxe-coburg_and_gotha	victoria_eugenia_of_battenberg|prince_maurice_of_battenberg	children|children
what is the organization of <e> 's father	lady_louisa_stuart	eton_college	parents|institution
what is the <e> 's mother 's dad	henry_i_duke_of_guise	renee_of_france	parents|parents
what sex is <e> 's father	eadgifu_of_england	male	parents|gender
what is <e> 's husband working on	ronald_reagan	actor	spouse|profession
what is <e> 's child 's ethnicity about	major_ridge	cherokee|native_americans_in_the_united_states	children|ethnicity
the sex of darling of <e>	ronald_reagan	female	spouse|gender
what is the <e> 's mom 's parents	lady_may_abel_smith	princess_helena_duchess_of_albany	parents|parents
the nationality of son of <e>	isabella_of_castile	spain	children|nationality
what is the <e> 's offspring 's sex	leonard_jerome	female	children|gender
the sex of <e> 's husband	john_of_gaunt_1st_duke_of_lancaster	female	spouse|gender
the gender of <e> 's child	john_iv_of_portugal	male	children|gender
<e> 's spouse 's parents	alva_belmont	william_henry_vanderbilt	spouse|parents
what killed the <e> 's mother	skip_caray	cardiovascular_disease	parents|cause_of_death
what is the nation of offspring of <e>	louis_duke_of_nemours	france	children|nationality
what is the sex of <e> 's dad	princess_elizabeth_of_england	female	parents|gender
what is the nation of <e> 's son	johann_bernoulli	netherlands	children|nationality
what is the name of the grandson of <e>	alexandre_vicomte_de_beauharnais	napoleon_iii_of_france	children|children
who is the heir of <e> 's other half	henriette_adelaide_of_savoy	joseph_clemens_of_bavaria	spouse|children
the place of birth of <e> 's dad	rudolf_christian_count_of_ostfriesland	aurich	parents|place_of_birth
the gender of daughter of <e>	hortense_de_beauharnais	male	children|gender
what is the mom of <e> 's father	princess_caroline_elizabeth_of_great_britain	george_i_of_great_britain	parents|parents
what is the <e> 's father 's darling	henry_viii_of_england	elizabeth_of_york	parents|spouse
the offspring of offspring of <e>	grand_duchess_alexandra_petrovna	princess_nadejda_petrovna_of_russia	children|children
the gender of child of <e>	augusta_viktoria_of_schleswig-holstein	male	children|gender
<e> 's couple 's nationality	anne_of_great_britain	denmark	spouse|nationality
where does <e> 's children work	roy_thomson_1st_baron_thomson_of_fleet	upper_canada_college	children|institution
what is the <e> 's father 's cause of death	george_darwin	coronary_thrombosis	parents|cause_of_death
what is the <e> 's son 's mother	william_starling_burgess	william_starling_burgess	children|parents
what is the nation of <e> 's offspring	henry_of_scotland_3rd_earl_of_huntingdon	kingdom_of_scotland	children|nationality
<e> 's father 's location	kikkawa_motoharu	aki_province	parents|location
which educational institution does <e> 's darling work for	effie_gray	christ_church_oxford	spouse|institution
what does <e> 's parents do for a living	buster_keaton	actor	parents|profession
is <e> 's husband a man or a woman	cecilia_renata_of_austria	male	spouse|gender
<e> 's children 's sex	aurangzeb	male	children|gender
the heir of <e> 's daughter	victoria_kinoiki_kekaulike	abigail_kapiolani_kawananakoa	children|children
what is the <e> 's child 's parents	anton_philips	anton_philips	children|parents
the place of birth of child of <e>	archduke_carl_ludwig_of_austria	graz	children|place_of_birth
what is the <e> 's parents 's children	ulysses_s_grant_jr	frederick_dent_grant	parents|children
what is the nation of mother of <e>	princess_elizabeth_of_england	kingdom_of_france	parents|nationality
what is the <e> 's father 's parents	henry_iii_of_france	madeleine_de_la_tour_dauvergne	parents|parents
the nation of child of <e>	svante_nilsson	sweden	children|nationality
<e> 's children 's dad	charles_i_of_england	henrietta_maria_of_france	children|parents
what sex is <e> 's darling	audrey_hepburn	male	spouse|gender
what is the race of darling of <e>	margaret_sullavan	jew	spouse|ethnicity
what is the father of daughter of <e>	louis_iv_of_france	gerberga_of_saxony	children|parents
is <e> 's husband a man or a woman	james_cruze	female	spouse|gender
who is the other half of <e> 's wife	henry_vii_of_england	henry_vii_of_england	spouse|spouse
what is the parent of couple of <e>	noble_consort_wan	yongzheng_emperor	spouse|parents
what is the <e> 's child 's gender	john_v_palaiologos	male	children|gender
<e> 's wife 's nation	vilhelmine_marie_of_denmark	denmark	spouse|nationality
what is the job of <e> 's kid	james_henry_hackett	actor	children|profession
where does <e> 's mom come from	henry_howard_7th_duke_of_norfolk	kingdom_of_england|england	parents|nationality
is <e> 's spouse a man or a woman	ptolemy_ix_lathyros	female	spouse|gender
<e> 's dad 's nation	frank_reicher	germany	parents|nationality
is <e> 's mother a man or a woman	pearl_starr	female	parents|gender
the cause of death of <e> 's mom	princess_tenagnework	allegedly_murdered	parents|cause_of_death
what is the ethnicity of wife of <e>	carlos_thompson	germans	spouse|ethnicity
the sex of other half of <e>	harry_hay	male	spouse|gender
<e> 's husband 's nation	phillip_terry	france	spouse|nationality
which institution does <e> 's dad work for	edward_smith_stanley_14th_earl_of_derby	trinity_college_cambridge	parents|institution
<e> 's offspring 's sex	maria_of_spain	male	children|gender
what is the name of the child of <e> 's parent	thomas_spurgeon	thomas_spurgeon	parents|children
the cause of death of <e> 's father	alexander_kara_or_evic_prince_of_serbia	assassination	parents|cause_of_death
<e> 's dad 's nationality	niels_bohr	denmark	parents|nationality
what is the place of birth of mom of <e>	anna_e_roosevelt	new_york	parents|place_of_birth
what is the father of <e> 's daughter	louis_iv_of_france	gerberga_of_saxony	children|parents
what religion does <e> 's spouse practice	edwin_samuel_montagu	judaism	spouse|religion
the race of <e> 's darling	margaret_sullavan	jew	spouse|ethnicity
what is the <e> 's heir 's nationality	gustaf_vi_adolf_of_sweden	sweden	children|nationality
who is the children of <e> 's daughter	p_j_kennedy	rosemary_kennedy	children|children
what is the work of father of <e>	george_grossmith_jr	novelist|singer	parents|profession
what is the <e> 's mother 's gender	charlotte_duchess_of_albany	male	parents|gender
what is the name of the grandparent of <e>	william_kissam_vanderbilt	cornelius_vanderbilt	parents|parents
what is the place of birth of <e> 's mom	adolphus_busch_iii	st_louis_missouri	parents|place_of_birth
what gender is <e> 's other half	grand_duchess_elizabeth_mikhailovna	male	spouse|gender
<e> 's wife 's parents	juba_ii	cleopatra_vii_of_egypt	spouse|parents
what does <e> 's parent do	princess_tenagnework	monarch	parents|profession
the sex of kid of <e>	christian_x_of_denmark	male	children|gender
where does <e> 's parent come from	george_herbert_11th_earl_of_pembroke	united_kingdom	parents|nationality
what is the <e> 's parents 's gender	andrey_bolshoy	male	parents|gender
<e> 's couple 's gender	ruth_roland	male	spouse|gender
what is <e> 's daughter	william_talbot	politician|lawyer	children|profession
who is the son of <e> 's parents	niels_bohr	harald_bohr	parents|children
<e> 's dad 's nation	henry_ii_of_england	kingdom_of_england	parents|nationality
what is the <e> 's other half 's gender	anne_of_bohemia	male	spouse|gender
what is the sex of husband of <e>	grand_duke_peter_nicolaievich_of_russia	female	spouse|gender
what is <e> 's other half working on	ekaterina_svanidze	generalissimo	spouse|profession
what killed the <e> 's mom	princess_tenagnework	allegedly_murdered	parents|cause_of_death
what is the <e> 's father 's occupation	edith_craig	architect	parents|profession
what is the job of <e> 's darling	elizabeth_blair_lee	naval_officer	spouse|profession
what is the work of kid of <e>	cosima_wagner	conducting|composer	children|profession
what is the gender of <e> 's parents	alfonso_iv_of_leon	male	parents|gender
what is the <e> 's son 's nation	johann_bernoulli	netherlands	children|nationality
<e> 's parents 's parents	princess_sophia_dorothea_of_prussia	sophia_dorothea_of_celle	parents|parents
what is the sex of wife of <e>	laura_borden	male	spouse|gender
what is the educational institution of spouse of <e>	virginia_heinlein	united_states_naval_academy	spouse|institution
the sex of dad of <e>	sviatoslav_ii_of_kiev	male	parents|gender
the gender of <e> 's couple	maria_luisa_of_savoy	male	spouse|gender
who is the children of <e> 's children	tiberius_nero	julius_caesar_drusus	children|children
what is the sex of offspring of <e>	adelaide_of_lowenstein_wertheim_rosenberg	female	children|gender
what is the nation of <e> 's child	svante_nilsson	sweden	children|nationality
what is the child of parents of <e>	anne_of_cleves	sybille_of_cleves	parents|children
the religious belief of other half of <e>	rani_mangammal	hinduism	spouse|religion
the sex of husband of <e>	claudius	female	spouse|gender
what religion does <e> 's wife have	infante_fernando_duke_of_viseu	roman_catholic_church	spouse|religion
what is the <e> 's wife 's profession	alexander_darcy	actor	spouse|profession
what is the nation of parent of <e>	ramon_berenguer_i_count_of_barcelona	spain	parents|nationality
what gender is <e> 's father	yixin_prince_gong	male	parents|gender
where is <e> 's daughter living	casimir_iv_jagiellon	krakow	children|location
what is the <e> 's father 's job	elisabeth_of_austria_1526	holy_roman_emperor	parents|profession
what is the gender of kid of <e>	alexandre_vicomte_de_beauharnais	female	children|gender
<e> 's offspring 's gender	artavasdes_i_of_armenia	male	children|gender
what sex is <e> 's other half	juba_ii	female	spouse|gender
<e> 's other half 's gender	samuel_gridley_howe	male|female	spouse|gender
what is the nationality of parents of <e>	claudius	roman_empire	parents|nationality
what is the occupation of offspring of <e>	frances_polidori	illustrator	children|profession
the sex of <e> 's mother	augustus_keppel_1st_viscount_keppel	male	parents|gender
the son of <e> 's father	charles_duke_of_lower_lorraine	lothair_of_france	parents|children
what type of religion does <e> 's dad practice	j_p_morgan_jr	anglicanism	parents|religion
what line of business is <e> 's parent in	ethel_lilian_voynich	mathematician	parents|profession
the daughter of parent of <e>	elisabeth_of_austria_1526	maria_of_habsburg_archduchess_of_austria	parents|children
what is the religious belief of <e> 's father	george_darwin	anglicanism|agnosticism	parents|religion
what is the <e> 's couple 's address	robert_lowell	london	spouse|location
<e> 's spouse 's job	richard_mulligan	actor	spouse|profession
the job of spouse of <e>	doris_blackburn	lawyer	spouse|profession
<e> 's darling 's wife	elizabeth_of_york	elizabeth_of_york	spouse|spouse
the place of death of <e> 's darling	anahareo	prince_albert	spouse|place_of_death
what is the nation of husband of <e>	mae_west	united_states	spouse|nationality
what is the type of religion of <e> 's couple	sarah	judaism	spouse|religion
the wife of heir of <e>	maria_of_spain	infanta_isabella_clara_eugenia_of_spain	children|spouse
what is the name of the parents of <e> 's daughter	thomas_thynne_2nd_viscount_weymouth	thomas_thynne_2nd_viscount_weymouth	children|parents
<e> 's wife 's nationality	sybil_thomas_viscountess_rhondda	wales|united_kingdom	spouse|nationality
what is the sex of darling of <e>	audrey_hepburn	male	spouse|gender
where does <e> 's parents come from	edward_salisbury_dana	united_states	parents|nationality
what is the <e> 's dad 's gender	boleslaw_ii_of_poland	male	parents|gender
what is the organization of <e> 's dad	john_f_kennedy_jr	riverdale_country_school|london_school_of_economics	parents|institution
what is the gender of mother of <e>	philip_ii_of_taranto	male	parents|gender
the place of death of mother of <e>	william_kissam_vanderbilt	new_york	parents|place_of_death
is <e> 's mother a man or a woman	charlotte_duchess_of_albany	male	parents|gender
the cause of death of dad of <e>	louise_juliana_of_nassau	assassination|firearm	parents|cause_of_death
what is the hometown of <e> 's children	archduchess_maria_beatrix_of_austria_este	ljubljana	children|place_of_birth
the sex of <e> 's kid	grand_duke_alexander_mikhailovich_of_russia	male	children|gender
what is the nation of <e> 's son	maria_luisa_of_parma	spain	children|nationality
what is the <e> 's parents 's sex	vasili_i_of_russia	female	parents|gender
<e> 's mom 's gender	catharina_of_sweden	male	parents|gender
the child of <e> 's mom	gaston_comte_deu	gaston_comte_deu	parents|children
how <e> 's spouse died	adolf_hitler	suicide|cyanide_poisoning	spouse|cause_of_death
the gender of daughter of <e>	erekle_i_of_kakheti	male	children|gender
the gender of dad of <e>	boleslaw_ii_of_poland	male	parents|gender
the sex of wife of <e>	james_hepburn_4th_earl_of_bothwell	female	spouse|gender
what is the nation of <e> 's husband	sybil_thomas_viscountess_rhondda	wales|united_kingdom	spouse|nationality
who is the granddad of <e>	prince_joachim_of_prussia	frederick_iii_german_emperor	parents|parents
what is the <e> 's other half 's nation	marie-anne_pierrette_paulze	united_kingdom|germany	spouse|nationality
what is the children of daughter of <e>	francis_iv_duke_of_modena	carlos_duke_of_madrid	children|children
what gender is <e> 's other half	benjamin_harrison	female	spouse|gender
what is the place of death of <e> 's husband	audrey_hepburn	santa_barbara	spouse|place_of_death
the other half of wife of <e>	henry_vii_of_england	henry_vii_of_england	spouse|spouse
what is the religious belief of husband of <e>	samuel_gridley_howe	unitarian_universalism	spouse|religion
the father of <e> 's children	henry_iii_holy_roman_emperor	henry_iii_holy_roman_emperor	children|parents
what is the name of the spouse of <e> 's mom	henry_i_duke_of_guise	jacques_de_savoie_2nd_duc_de_nemours	parents|spouse
the educational institution of other half of <e>	caroline_webster_schermerhorn_astor	columbia_university	spouse|institution
is <e> 's mother a man or a woman	niels_bohr	male	parents|gender
the sex of parent of <e>	louis_philippe_i_duke_of_orleans	male	parents|gender
what is the <e> 's couple 's educational institution	mary_stuart_countess_of_bute	eton_college	spouse|institution
what is the <e> 's spouse 's job	evelyn_keyes	composer	spouse|profession
the gender of <e> 's mom	regina_crown_princess_of_austria	male	parents|gender
what did <e> 's children die from	srinagarindra	firearm	children|cause_of_death
the sex of <e> 's parent	prince_louis_ferdinand_of_bavaria	female	parents|gender
what is <e> 's couple 's ethnicity about	george_tabori	swedish_american|swedish_people	spouse|ethnicity
the gender of <e> 's daughter	hortense_de_beauharnais	male	children|gender
the sex of other half of <e>	georg_donatus_hereditary_grand_duke_of_hesse	female	spouse|gender
what is the husband of <e> 's mother	robert_i_duke_of_burgundy	constance_of_arles	parents|spouse
<e> 's kid 's job	thomas_thynne_2nd_viscount_weymouth	politician	children|profession
what is the ethnicity of heir of <e>	alice_betty_stern	germans	children|ethnicity
the occupation of <e> 's husband	ronald_reagan	actor	spouse|profession
what is the race of <e> 's offspring	artavasdes_i_of_armenia	armenians	children|ethnicity
what is <e> 's other half working on	luis_munoz_marin	first_lady	spouse|profession
what faith does <e> 's child have	george_of_saxony	roman_catholic_church	children|religion
the institution of <e> 's kid	anton_philips	delft_university_of_technology	children|institution
what does <e> 's husband do	roger_needham	computer_scientist	spouse|profession
what is the nationality of other half of <e>	edward_blake	canada	spouse|nationality
the gender of <e> 's couple	kira_kirillovna_of_russia	male	spouse|gender
what is <e> 's father	henry_viii_of_england	monarch	parents|profession
who is the offspring of <e> 's mom	tasha_tudor	tasha_tudor	parents|children
what is the <e> 's spouse 's nation	margaret_sullavan	france	spouse|nationality
the heir of parent of <e>	catherine_of_braganza	teodosio_prince_of_brazil	parents|children
the faith of husband of <e>	marie-anne_pierrette_paulze	anglicanism	spouse|religion
the work of kid of <e>	blessed_virgin_mary	carpenter	children|profession
which organization does <e> 's son work for	john_b_kelly_sr	american_academy_of_dramatic_arts	children|institution
<e> 's child 's father	yongzheng_emperor	yongzheng_emperor	children|parents
what is the mother of <e> 's wife	caesonia	germanicus	spouse|parents
where does <e> 's son come from	isabella_of_castile	spain	children|nationality
where does <e> 's couple work for	mary_stuart_countess_of_bute	eton_college	spouse|institution
the nationality of <e> 's child	john_d_rockefeller_jr	united_states	children|nationality
is <e> 's husband a man or a woman	samuel_pepys	female	spouse|gender
what is the nation of <e> 's other half	anahareo	canada|united_states	spouse|nationality
what religious belief does <e> 's parents practice	mihrimar	islam	parents|religion
what gender is <e> 's mom	regina_crown_princess_of_austria	male	parents|gender
what is the son of parent of <e>	archduke_louis_of_austria	rudolf_cardinal_von_habsburg_lothringen|archduke_joseph_of_austria_palatine_of_hungary	parents|children
what is the nationality of <e> 's daughter	john_spencer_churchill_7th_duke_of_marlborough	united_kingdom|england	children|nationality
which city did <e> 's wife born	adolf_hitler	munich	spouse|place_of_birth
<e> 's mother 's sex	false_dmitriy_i	male	parents|gender
who is the children of <e> 's mother	henry_i_duke_of_guise	charles_of_lorraine_duke_of_mayenne	parents|children
what is the race of <e> 's spouse	elizabeth_de_burgh	scottish_people	spouse|ethnicity
what does <e> 's children do for a living	princess_margaret_of_connaught	prince	children|profession
<e> 's other half 's nationality	princess_sibylla_of_saxe-coburg_and_gotha	sweden	spouse|nationality
the nation of <e> 's spouse	luz_magsaysay	philippines	spouse|nationality
the sex of offspring of <e>	adelaide_of_lowenstein_wertheim_rosenberg	female	children|gender
what is the sex of <e> 's daughter	qianlong_emperor	male	children|gender
<e> 's child 's nation	svante_nilsson	sweden	children|nationality
<e> 's daughter 's gender	hortense_de_beauharnais	male	children|gender
the gender of <e> 's darling	franz_joseph_i_of_austria	female	spouse|gender
where did the darling of <e> die	anna_lee	santa_barbara	spouse|place_of_death
why <e> 's spouse died	adolf_hitler	suicide|cyanide_poisoning	spouse|cause_of_death
what is <e> 's kid working on	john_hays_hammond	inventor	children|profession
what is the nation of <e> 's parent	david_carradine	united_states	parents|nationality
what is the place of death of <e> 's father	roy_e_disney	burbank	parents|place_of_death
the gender of <e> 's other half	samuel_gridley_howe	male|female	spouse|gender
<e> 's offspring 's nation	john_spencer_churchill_7th_duke_of_marlborough	united_kingdom|england	children|nationality
where does <e> 's mother come from	marie_francois_sadi_carnot	france	parents|nationality
the nationality of <e> 's other half	princess_sibylla_of_saxe-coburg_and_gotha	sweden	spouse|nationality
what is the <e> 's husband 's gender	martha_bulloch	male	spouse|gender
what is <e> 's daughter working on	alexandra_fyodorovna_of_hesse	grand_duchess	children|profession
the nation of <e> 's darling	alva_belmont	united_states	spouse|nationality
is <e> 's darling a man or a woman	elizabeth_macquarie	male	spouse|gender
which institution does <e> 's children work for	roy_thomson_1st_baron_thomson_of_fleet	upper_canada_college	children|institution
<e> 's parent 's sex	penelope_blount_countess_of_devonshire	male	parents|gender
what is the nation of <e> 's husband	mary_stuart_countess_of_bute	scotland	spouse|nationality
what is the <e> 's dad 's cause of death	justinus_van_nassau	assassination|firearm	parents|cause_of_death
the gender of <e> 's child	augusta_viktoria_of_schleswig-holstein	male	children|gender
the nationality of <e> 's wife	sybil_thomas_viscountess_rhondda	wales|united_kingdom	spouse|nationality
the nation of mom of <e>	lady_sarah_wilson	united_kingdom	parents|nationality
<e> 's other half 's sex	georg_donatus_hereditary_grand_duke_of_hesse	female	spouse|gender
is <e> 's wife a man or a woman	verina	male	spouse|gender
what sex is <e> 's parent	prince_louis_ferdinand_of_bavaria	female	parents|gender
what is the <e> 's father 's place of death	titus_van_rijn	amsterdam	parents|place_of_death
what city did <e> 's son die	maria_fyodorovna_of_russia	vienna	children|place_of_death
what line of business is <e> 's dad in	louis_the_pious	emperor	parents|profession
the other half of <e> 's father	isabella_of_france	joan_i_of_navarre	parents|spouse
the gender of <e> 's couple	ekaterina_svanidze	male	spouse|gender
what is the offspring of dad of <e>	clodoald	clodoald	parents|children
<e> 's son 's nation	maria_luisa_of_parma	spain	children|nationality
what is the gender of <e> 's couple	empress_xiaomu	male	spouse|gender
is <e> 's couple a man or a woman	ruth_roland	male	spouse|gender
<e> 's husband 's nation	sybil_thomas_viscountess_rhondda	wales|united_kingdom	spouse|nationality
what is the nationality of <e> 's parent	frederika_of_hanover	germany	parents|nationality
what is the sex of <e> 's spouse	jeanne_ii_countess_of_burgundy	male	spouse|gender
what is the name of the son of <e> 's parent	princess_margaret_of_prussia	princess_charlotte_of_prussia	parents|children
what is the name of the son of <e> 's husband	caroline_webster_schermerhorn_astor	john_jacob_astor_iv	spouse|children
what is the <e> 's dad 's gender	henry_cromwell	female	parents|gender
what is the father of <e> 's daughter	ellen_terry	edward_william_godwin	children|parents
what sex is <e> 's darling	colleen_dewhurst	male	spouse|gender
what is the husband of heir of <e>	philip_v_of_spain	joseph_i_of_portugal	children|spouse
what is the cause of death of husband of <e>	doris_dowling	diabetes_mellitus	spouse|cause_of_death
the job of son of <e>	john_b_kelly_sr	fashion_model	children|profession
the sex of <e> 's darling	kalama	male	spouse|gender
what type of religion does <e> 's mom practice	domenico_tintoretto	catholicism	parents|religion
what is the heir of child of <e>	jodhabai	shah_jahan	children|children
what type of religion is <e> 's couple	sarah	judaism	spouse|religion
where did <e> 's husband die	kalama	honolulu	spouse|place_of_death
what is <e> 's kid working on	emperor_temmu	writer	children|profession
<e> 's husband 's religious belief	samuel_gridley_howe	unitarian_universalism	spouse|religion
what is the <e> 's parent 's nation	pearl_starr	united_states	parents|nationality
what is the name of the granddaughter of <e>	duke_peter_of_oldenburg	grand_duke_peter_nicolaievich_of_russia|grand_duke_nicholas_nicolaevich_the_younger	children|children
is <e> 's darling a man or a woman	elizabeth_allan_1908	male	spouse|gender
what is the <e> 's mother 's religious belief	charles_ferdinand_duc_de_berry	catholicism	parents|religion
who is the grandchild of <e>	albert_of_saxe-coburg_and_gotha	victoria_eugenia_of_battenberg|prince_maurice_of_battenberg	children|children
the gender of <e> 's darling	empress_xiaoquan_cheng	male	spouse|gender
the heir of daughter of <e>	victoria_kinoiki_kekaulike	abigail_kapiolani_kawananakoa	children|children
the nationality of <e> 's dad	titus_van_rijn	netherlands	parents|nationality
what made the <e> 's momdead	princess_tenagnework	allegedly_murdered	parents|cause_of_death
what type of religion is <e> 's heir	alice_betty_stern	jew	children|religion
what is the name of the wife of <e> 's darling	marjorie_merriweather_post	marjorie_merriweather_post	spouse|spouse
what is the hometown of <e> 's child	archduke_carl_ludwig_of_austria	graz	children|place_of_birth
what is the <e> 's offspring 's nation	henry_of_scotland_3rd_earl_of_huntingdon	kingdom_of_scotland	children|nationality
what is the <e> 's darling 's gender	benjamin_disraeli_1st_earl_of_beaconsfield	female	spouse|gender
what is the name of the father of <e> 's daughter	ellen_terry	edward_william_godwin	children|parents
what is the sex of <e> 's mother	augustus_keppel_1st_viscount_keppel	male	parents|gender
the sex of <e> 's husband	claudius	female	spouse|gender
the sex of husband of <e>	john_of_gaunt_1st_duke_of_lancaster	female	spouse|gender
what sex is <e> 's child	svante_nilsson	male	children|gender
<e> 's parents 's sex	tyrone_power	male	parents|gender
what caused the <e> 's father 's death	alexander_kara_or_evic_prince_of_serbia	assassination	parents|cause_of_death
<e> 's husband 's nation	mae_west	united_states	spouse|nationality
what is the son of <e> 's parent	robert_c_wickliffe	robert_c_wickliffe	parents|children
the address of parents of <e>	skip_caray	st_louis_missouri	parents|location
is <e> 's husband a man or a woman	claudius	female	spouse|gender
the nationality of <e> 's mother	marie_francois_sadi_carnot	france	parents|nationality
how <e> 's mom died	caligula	assassination	parents|cause_of_death
who is the father of <e> 's wife	aelia_eudoxia	theodosius_i	spouse|parents
what is the gender of <e> 's spouse	helena_of_moscow	male	spouse|gender
<e> 's wife 's ethnicity	noble_consort_wan	manchu	spouse|ethnicity
the educational institution of <e> 's couple	mary_stuart_countess_of_bute	eton_college	spouse|institution
<e> 's kid 's gender	marie_of_edinburgh	male	children|gender
the nationality of <e> 's child	charles_a_wickliffe	united_states	children|nationality
what is the <e> 's darling 's sex	albert_vii_archduke_of_austria	female	spouse|gender
<e> 's father 's nation	catherine_carey	kingdom_of_england	parents|nationality
the place of death of <e> 's offspring	augustus_ii_the_strong	avignon	children|place_of_death
what type of religion does <e> 's daughter have	franz_josef_i_prince_of_liechtenstein	catholicism	children|religion
the sex of <e> 's offspring	hermann_einstein	female	children|gender
is <e> 's kid a man or a woman	anton_philips	male	children|gender
which nationality is <e> 's son	grand_duke_konstantin_nikolayevich_of_russia	russia	children|nationality
what is the <e> 's wife 's work	ernest_hemingway	journalist	spouse|profession
what is the nation of <e> 's husband	mae_west	united_states	spouse|nationality
what is the nation of <e> 's spouse	luz_magsaysay	philippines	spouse|nationality
the place of death of <e> 's husband	audrey_hepburn	santa_barbara	spouse|place_of_death
<e> 's parents 's place of death	louis_xvi_of_france	chateau_de_fontainebleau	parents|place_of_death
the son of mom of <e>	john_ii_casimir_of_poland	alexander_charles_vasa	parents|children
where does <e> 's kid come from	hortense_de_beauharnais	france	children|nationality
what is the couple of <e> 's kid	elena_pavlovna_of_wurttemberg	adolphe_grand_duke_of_luxembourg	children|spouse
what sex is <e> 's parents	vasili_i_of_russia	female	parents|gender
what is the <e> 's daughter 's heir	christiane_eberhardine_of_brandenburg_bayreuth	marie_josephe_of_saxony	children|children
what is the wife of couple of <e>	bobby_troup	bobby_troup	spouse|spouse
what is the kid of father of <e>	charles_lennox_2nd_duke_of_richmond	charles_lennox_2nd_duke_of_richmond|anne_van_keppel_countess_of_albemarle	parents|children
what is the name of the daughter of <e> 's parent	louis_of_bourbon_duke_of_orleans	duc_dorleans	parents|children
what is the sex of darling of <e>	samuel_gridley_howe	male|female	spouse|gender
the organization of <e> 's father	james_a_bayard_jr	princeton_university	parents|institution
<e> 's dad 's kid	henry_iv_holy_roman_emperor	henry_iv_holy_roman_emperor	parents|children
<e> 's husband 's sex	matilda_of_flanders	male	spouse|gender
where does <e> 's husband work for	julie_london	wharton_school_of_the_university_of_pennsylvania	spouse|institution
what is the gender of <e> 's mother	anne_of_cleves	male	parents|gender
which nationality is <e> 's spouse	peter_sellers	england	spouse|nationality
what is the <e> 's mother 's sex	techichpotzin	male	parents|gender
where did the kid of <e> die	princess_beatrice_of_the_united_kingdom	lausanne	children|place_of_death
the daughter of <e> 's parent	takelot_iii	takelot_iii	parents|children
what is the nation of <e> 's husband	phillip_terry	france	spouse|nationality
what is the <e> 's child 's dad	gustavus_adolphus_of_sweden	maria_eleonora_of_brandenburg	children|parents
what is the <e> 's offspring 's kid	yongzheng_emperor	jiaqing_emperor	children|children
the place of death of <e> 's heir	francis_iv_duke_of_modena	graz	children|place_of_death
what religion is <e> 's wife	infante_fernando_duke_of_viseu	roman_catholic_church	spouse|religion
<e> 's child 's gender	grand_duke_michael_mihailovich_of_russia	female	children|gender
is <e> 's wife a man or a woman	huey_long	female	spouse|gender
<e> 's kid 's daughter	marguerite_of_france	elizabeth_of_rhuddlan	children|children
what is the <e> 's parent 's daughter	louis_of_bourbon_duke_of_orleans	duc_dorleans	parents|children
what is the name of the parents of <e> 's spouse	alva_belmont	william_henry_vanderbilt	spouse|parents
the gender of <e> 's child	barbu_stirbey	male	children|gender
what is the <e> 's other half 's gender	talitha_getty	male	spouse|gender
what is <e> 's child	gheorghe_i_tasca	politician	children|profession
what is the <e> 's heir 's sex	mutemwiya_wife_of_thutmose_iv	male	children|gender
what is the <e> 's offspring 's offspring	grand_duchess_alexandra_petrovna	princess_nadejda_petrovna_of_russia	children|children
what is the <e> 's darling 's sex	audrey_hepburn	male	spouse|gender
what is the type of religion of couple of <e>	sarah	judaism	spouse|religion
<e> 's heir 's sex	mutemwiya_wife_of_thutmose_iv	male	children|gender
what is the gender of <e> 's couple	gaius_marius	male	spouse|gender
what is the <e> 's children 's darling	james_ii_of_england	george_of_denmark	children|spouse
what is the name of the dad of <e> 's children	charles_i_of_england	henrietta_maria_of_france	children|parents
what is the daughter of spouse of <e>	noble_consort_wan	jiaqing_emperor	spouse|children
what is the <e> 's dad 's nationality	titus_van_rijn	netherlands	parents|nationality
what did <e> 's kid die from	john_d_rockefeller_jr	myocardial_infarction	children|cause_of_death
the faith of parent of <e>	muhammad_al-mahdi	shia_islam	parents|religion
what sex is <e> 's offspring	hermann_einstein	female	children|gender
who is the grandmom of <e>	stephen_i_of_hungary	taksony_of_hungary	parents|parents
the place of death of father of <e>	titus_van_rijn	amsterdam	parents|place_of_death
what faith is <e> 's child	george_of_saxony	roman_catholic_church	children|religion
what is the sex of heir of <e>	marie_antoinette	female	children|gender
what is the gender of <e> 's mom	george_formby	male	parents|gender
what is the nation of <e> 's dad	frank_reicher	germany	parents|nationality
what is the parents of wife of <e>	juba_ii	cleopatra_vii_of_egypt	spouse|parents
<e> 's son 's mother	grand_duke_konstantin_nikolayevich_of_russia	alexandra_iosifovna_of_altenburg	children|parents
<e> 's mom 's profession	george_grossmith_jr	novelist|singer	parents|profession
what is <e> 's kid	marvin_pentz_gay_sr	composer|record_producer	children|profession
the nationality of parent of <e>	a_k_faezul_huq	bangladesh	parents|nationality
the nationality of <e> 's daughter	john_spencer_churchill_7th_duke_of_marlborough	united_kingdom|england	children|nationality
what is the <e> 's other half 's nationality	edward_blake	canada	spouse|nationality
<e> 's couple 's gender	phillip_terry	female	spouse|gender
what is the <e> 's mom 's gender	thomas_lamb_eliot	male	parents|gender
the faith of <e> 's offspring	hermann_einstein	jew	children|religion
is <e> 's offspring a man or a woman	frederick_iii_german_emperor	female	children|gender
what is the name of the couple of <e> 's couple	julie_london	julie_london	spouse|spouse
what is the gender of <e> 's mom	thomas_lamb_eliot	male	parents|gender
where did the offspring of <e> die	constantine_viii	constantinople	children|place_of_death
what is the name of the child of <e> 's parent	shah_shuja	shah_shuja	parents|children
the sex of heir of <e>	marie_antoinette	female	children|gender
what is the <e> 's children 's heir	wang_khan	mongke_khan	children|children
what is the son of kid of <e>	leopold_grand_duke_of_baden	grand_duke_alexei_mikhailovich_of_russia	children|children
the sex of offspring of <e>	maria_fyodorovna_of_russia	female	children|gender
what killed the <e> 's couple	anahareo	pneumonia	spouse|cause_of_death
what is the sex of <e> 's dad	elena_of_montenegro	male	parents|gender
what is the gender of other half of <e>	talitha_getty	male	spouse|gender
who is the children of <e> 's parents	ulysses_s_grant_jr	frederick_dent_grant	parents|children
what sex is <e> 's kid	christian_x_of_denmark	male	children|gender
why <e> 's couple died	carole_lombard	myocardial_infarction	spouse|cause_of_death
where does <e> 's spouse work	virginia_heinlein	united_states_naval_academy	spouse|institution
where is <e> 's daughter staying	louise_defeo	new_york_state	children|location
who is the children of <e> 's daughter	francis_iv_duke_of_modena	carlos_duke_of_madrid	children|children
what is the type of religion of mom of <e>	domenico_tintoretto	catholicism	parents|religion
who is the daughter of <e> 's mom	louise_elisabeth_of_orleans	duc_dorleans	parents|children
where does <e> 's parent come from	a_k_faezul_huq	bangladesh	parents|nationality
what is the husband of husband of <e>	james_hepburn_4th_earl_of_bothwell	francis_ii_of_france	spouse|spouse
what is the place of birth of wife of <e>	alice_of_bourbon_parma	florence	spouse|place_of_birth
<e> 's mother 's gender	charlotte_duchess_of_albany	male	parents|gender
<e> 's child 's darling	sam_marx	susan_fleming	children|spouse
where does <e> 's darling come from	edwin_samuel_montagu	united_kingdom	spouse|nationality
the faith of <e> 's parent	muhammad_al-mahdi	shia_islam	parents|religion
the cause of death of <e> 's kid	nicholas_ii_of_russia	murder|firearm	children|cause_of_death
what is the nationality of other half of <e>	princess_sibylla_of_saxe-coburg_and_gotha	sweden	spouse|nationality
where does <e> 's darling come from	lew_cody	united_states	spouse|nationality
is <e> 's son a man or a woman	maximilian_i_of_bavaria	male	children|gender
the occupation of <e> 's daughter	william_talbot	politician|lawyer	children|profession
is <e> 's heir a man or a woman	sylvia_likens	male	children|gender
what is the place of birth of <e> 's mom	vittorio_emanuele_count_of_turin	turin	parents|place_of_birth
what religion does <e> 's wife have	mary_josephine_hannon_fitzgerald	catholicism	spouse|religion
the nation of dad of <e>	henry_ii_of_england	kingdom_of_england	parents|nationality
the address of <e> 's children	johann_conrad_weiser_sr	baden-wurttemberg	children|location
what is the sex of <e> 's mother	false_dmitriy_i	male	parents|gender
the wife of <e> 's heir	maria_of_spain	infanta_isabella_clara_eugenia_of_spain	children|spouse
what gender is <e> 's darling	elizabeth_allan_1908	male	spouse|gender
<e> 's parent 's gender	thutmose_iv	male	parents|gender
the nationality of spouse of <e>	margaret_of_artois	france	spouse|nationality
what is the gender of offspring of <e>	gustavus_adolphus_of_sweden	female	children|gender
what is the <e> 's dad 's place of birth	rudolf_christian_count_of_ostfriesland	aurich	parents|place_of_birth
what is the <e> 's kid 's gender	henrietta_anne_stuart	female	children|gender
the profession of <e> 's parent	wladyslaw_czartoryski	politician	parents|profession
<e> 's parent 's sex	prince_louis_ferdinand_of_bavaria	female	parents|gender
what is the cause of death of child of <e>	adolf_frederick_of_sweden	firearm	children|cause_of_death
what is the nation of <e> 's son	grand_duke_konstantin_nikolayevich_of_russia	russia	children|nationality
what is the sex of offspring of <e>	hermann_einstein	female	children|gender
what is the name of the daughter of <e> 's mom	louise_elisabeth_of_orleans	duc_dorleans	parents|children
what religion does <e> 's father follow	george_darwin	anglicanism|agnosticism	parents|religion
what made the <e> 's kiddead	nicholas_ii_of_russia	murder|firearm	children|cause_of_death
what is <e> 's parent 's race about	simeon_uro	serbs	parents|ethnicity
what is the organization of father of <e>	james_a_bayard_jr	princeton_university	parents|institution
what is <e> 's darling working on	elizabeth_blair_lee	naval_officer	spouse|profession
where is <e> 's daughter staying	casimir_iv_jagiellon	krakow	children|location
where does <e> 's spouse come from	margaret_sullavan	france	spouse|nationality
where did <e> 's darling born	maria_victoria_al_pozzo_della_cisterna	turin	spouse|place_of_birth
what is the dad of <e> 's parents	prince_joachim_of_prussia	frederick_iii_german_emperor	parents|parents
what is the nation of <e> 's spouse	bettye_ackerman	united_states	spouse|nationality
what is the <e> 's child 's nation	edmund_stafford_5th_earl_of_stafford	kingdom_of_england	children|nationality
the occupation of husband of <e>	ronald_reagan	actor	spouse|profession
the darling of <e> 's father	henry_viii_of_england	elizabeth_of_york	parents|spouse
what is the sex of mother of <e>	rasmus_bartholin	male	parents|gender
the address of children of <e>	johann_conrad_weiser_sr	baden-wurttemberg	children|location
the sex of children of <e>	aurangzeb	male	children|gender
the children of daughter of <e>	p_j_kennedy	rosemary_kennedy	children|children
what is the sex of dad of <e>	elena_of_montenegro	male	parents|gender
what is the gender of couple of <e>	maria_luisa_of_savoy	male	spouse|gender
what is the sex of <e> 's darling	kalama	male	spouse|gender
what is the name of the grandchildren of <e>	tiberius_nero	julius_caesar_drusus	children|children
where is <e> 's parents staying	ray_bridwell_white	kentucky	parents|location
<e> 's children 's gender	nicholas_ii_of_russia	female	children|gender
what is the sex of <e> 's kid	grand_duke_alexander_mikhailovich_of_russia	male	children|gender
<e> 's wife 's sex	laura_borden	male	spouse|gender
the gender of couple of <e>	ekaterina_svanidze	male	spouse|gender
<e> 's parents 's occupation	david_carradine	actor	parents|profession
what is the reason of <e> 's dad 's death	justinus_van_nassau	assassination|firearm	parents|cause_of_death
the gender of <e> 's kid	claudine_rhedey_von_kis_rhede	male	children|gender
what faith does <e> 's heir have	jawaharlal_nehru	hinduism	children|religion
the nation of child of <e>	edmund_stafford_5th_earl_of_stafford	kingdom_of_england	children|nationality
the gender of couple of <e>	pearl_bailey	male	spouse|gender
the gender of <e> 's mom	catharina_of_sweden	male	parents|gender
what is the name of the spouse of <e> 's mom	saovabha	mongkut	parents|spouse
what is the name of the dad of <e> 's children	charles_spurgeon	charles_spurgeon	children|parents
the nation of <e> 's son	grand_duke_konstantin_nikolayevich_of_russia	russia	children|nationality
the nation of <e> 's parent	john_i_of_denmark	germany	parents|nationality
the gender of kid of <e>	marie_of_edinburgh	male	children|gender
where does <e> 's kid work for	anton_philips	delft_university_of_technology	children|institution
what is the <e> 's mother 's children	henry_i_duke_of_guise	charles_of_lorraine_duke_of_mayenne	parents|children
the work of <e> 's mother	nissanka_wijeyeratne	diplomat	parents|profession
the sex of mother of <e>	postumus_junior	male	parents|gender
who is the parents of <e> 's daughter	thomas_thynne_2nd_viscount_weymouth	thomas_thynne_2nd_viscount_weymouth	children|parents
where does <e> 's dad come from	niels_bohr	denmark	parents|nationality
what race is <e> 's daughter	marvin_pentz_gay_sr	african_american	children|ethnicity
the nationality of <e> 's children	marguerite_of_france	england	children|nationality
where does <e> 's wife come from	vilhelmine_marie_of_denmark	denmark	spouse|nationality
what religion does <e> 's father have	george_darwin	anglicanism|agnosticism	parents|religion
the sex of dad of <e>	princess_elizabeth_of_england	female	parents|gender
<e> 's offspring 's sex	sherman_hoar	male	children|gender
<e> 's mom 's couple	sunandha	mongkut	parents|spouse
what did <e> 's father die from	george_darwin	coronary_thrombosis	parents|cause_of_death
what is the <e> 's son 's profession	nathan_mayer_rothschild	politician	children|profession
what is the parents of <e> 's mom	louis_philippe_i_duke_of_orleans	francoise_marie_de_bourbon	parents|parents
what does <e> 's offspring do for a living	cosima_wagner	conducting|composer	children|profession
the sex of children of <e>	francis_ii_holy_roman_emperor	female	children|gender
which nationality is <e> 's mom	henry_howard_7th_duke_of_norfolk	kingdom_of_england|england	parents|nationality
what is the occupation of other half of <e>	luis_munoz_marin	first_lady	spouse|profession
please tell me <e> 's parents present address	ray_bridwell_white	kentucky	parents|location
who is the parents of <e> 's wife	juba_ii	cleopatra_vii_of_egypt	spouse|parents
what is the name of the darling of <e> 's darling	arcadius	arcadius	spouse|spouse
what caused the <e> 's father 's death	prince_joachim_of_prussia	pulmonary_embolism	parents|cause_of_death
the cause of death of daughter of <e>	nicholas_ii_of_russia	murder|firearm	children|cause_of_death
what is the <e> 's other half 's father	infanta_maria_de_la_paz_of_spain	infanta_amelia_philippina_of_spain	spouse|parents
what religion is <e> 's heir	louis_ix_of_france	catholicism	children|religion
what is <e> 's heir 's race about	major_ridge	cherokee|native_americans_in_the_united_states	children|ethnicity
the nationality of child of <e>	charles_a_wickliffe	united_states	children|nationality
the kid of <e> 's parents	qianlong_emperor	qianlong_emperor	parents|children
what is the <e> 's son 's place of birth	ferdinand_maria_elector_of_bavaria	munich	children|place_of_birth
what does <e> 's parents do	david_carradine	actor	parents|profession
the daughter of mom of <e>	laura_marx	jenny_longuet	parents|children
<e> 's husband 's cause of death	evelyn_keyes	diabetes_mellitus	spouse|cause_of_death
what is the <e> 's darling 's gender	elizabeth_allan_1908	male	spouse|gender
the daughter of <e> 's mom	louise_elisabeth_of_orleans	duc_dorleans	parents|children
what is the place of death of <e> 's parents	louis_xvi_of_france	chateau_de_fontainebleau	parents|place_of_death
what is the <e> 's wife 's mother	caesonia	germanicus	spouse|parents
<e> 's heir 's race	major_ridge	cherokee|native_americans_in_the_united_states	children|ethnicity
what religious belief does <e> 's father practice	george_darwin	anglicanism|agnosticism	parents|religion
what is the parents of mom of <e>	louis_philippe_i_duke_of_orleans	francoise_marie_de_bourbon	parents|parents
what is the wife of darling of <e>	elizabeth_of_york	elizabeth_of_york	spouse|spouse
what is the address of <e> 's couple	robert_lowell	london	spouse|location
what is <e> 's wife	verina	eastern_roman_emperor	spouse|profession
what does <e> 's father do	henry_viii_of_england	monarch	parents|profession
the nationality of son of <e>	pierre_curie	france	children|nationality
<e> 's child 's place of death	cheryl_crowe	escondido	children|place_of_death
what is the <e> 's dad 's sex	lady_cynthia_mosley	female	parents|gender
what is the <e> 's daughter 's other half	grand_duchess_alexandra_petrovna	anastasia_of_montenegro	children|spouse
the nation of <e> 's daughter	nathan_mayer_rothschild	united_kingdom	children|nationality
what is the nation of <e> 's other half	marie-anne_pierrette_paulze	united_kingdom|germany	spouse|nationality
<e> 's couple 's parent	noble_consort_wan	yongzheng_emperor	spouse|parents
what sex is <e> 's mother	postumus_junior	male	parents|gender
the sex of offspring of <e>	charles_lennox_1st_duke_of_richmond	male|female	children|gender
the ethnicity of <e> 's child	yongzheng_emperor	manchu	children|ethnicity
<e> 's husband 's cause of death	virginia_heinlein	emphysema	spouse|cause_of_death
what is the nation of <e> 's mom	philip_iii_of_navarre	france	parents|nationality
the sex of <e> 's kid	alexander_ferdinand_3rd_prince_of_thurn_and_taxis	male	children|gender
<e> 's other half 's gender	irina_godunova	male	spouse|gender
what is the sex of <e> 's child	svante_nilsson	male	children|gender
what is the <e> 's kid 's father	charles_a_wickliffe	charles_a_wickliffe	children|parents
what is the daughter of parents of <e>	infante_joao_of_portugal	infanta_isabel_duchess_of_burgundy	parents|children
what is <e> 's husband	anna_lee	screenwriter	spouse|profession
where does <e> 's kid come from	louise_of_mecklenburg-strelitz	germany	children|nationality
what is the <e> 's wife 's child	charles_i_duke_of_burgundy	mary_of_burgundy	spouse|children
what killed the <e> 's mom	penelope_blount_countess_of_devonshire	dysentery	parents|cause_of_death
the nation of <e> 's parent	ramon_berenguer_i_count_of_barcelona	spain	parents|nationality
what is the children of <e> 's daughter	p_j_kennedy	rosemary_kennedy	children|children
which city did <e> 's child born	archduke_carl_ludwig_of_austria	graz	children|place_of_birth
the race of <e> 's father	princess_tenagnework	oromo	parents|ethnicity
what is the child of <e> 's mom	grand_duke_george_mikhailovich_of_russia	grand_duke_alexei_mikhailovich_of_russia	parents|children
what is the gender of <e> 's heir	leopold_ii_holy_roman_emperor	male	children|gender
what is the occupation of parent of <e>	princess_tenagnework	monarch	parents|profession
<e> 's parent 's location	george_darwin	shrewsbury	parents|location
the gender of <e> 's parent	thutmose_iv	male	parents|gender
the sex of <e> 's mother	techichpotzin	male	parents|gender
where does <e> 's parent come from	david_carradine	united_states	parents|nationality
what is the <e> 's spouse 's sex	jeanne_ii_countess_of_burgundy	male	spouse|gender
what does <e> 's mother do	nissanka_wijeyeratne	diplomat	parents|profession
what is the place of birth of children of <e>	pierre_curie	paris	children|place_of_birth
the nation of children of <e>	william_backhouse_astor_jr	united_states	children|nationality
what is the location of other half of <e>	auguste_van_pels	lower_saxony	spouse|location
what is the dad of <e> 's children	charles_i_of_england	henrietta_maria_of_france	children|parents
is <e> 's darling a man or a woman	kalama	male	spouse|gender
what is the name of the daughter of <e> 's mom	laura_marx	jenny_longuet	parents|children
the gender of <e> 's heir	henry_ii_of_france	male	children|gender
what is the <e> 's child 's job	sigurd_ibsen	film_director|screenwriter	children|profession
how <e> 's dad died	lynn_redgrave	parkinsons_disease	parents|cause_of_death
<e> 's offspring 's children	jahangir	dara_shikoh	children|children
what is the <e> 's husband 's husband	james_hepburn_4th_earl_of_bothwell	francis_ii_of_france	spouse|spouse
the nationality of <e> 's wife	anne_of_york	england	spouse|nationality
what is the job of <e> 's spouse	richard_mulligan	actor	spouse|profession
what is the <e> 's son 's place of death	maria_fyodorovna_of_russia	vienna	children|place_of_death
what is the profession of husband of <e>	roger_needham	computer_scientist	spouse|profession
where does <e> 's child work for	victoria_of_the_united_kingdom	trinity_college_cambridge	children|institution
<e> 's mother 's heir	marguerite_of_france	louis_devreux	parents|children
what is the <e> 's child 's occupation	anne_of_denmark	poet	children|profession
<e> 's offspring 's child	francis_i_of_france	charles_ix_of_france	children|children
what is <e> 's spouse working on	evelyn_keyes	composer	spouse|profession
what is the name of the wife of <e> 's couple	bobby_troup	bobby_troup	spouse|spouse
what gender is <e> 's spouse	helena_of_moscow	male	spouse|gender
what is the work of <e> 's parents	buster_keaton	actor	parents|profession
what made the <e> 's daughterdead	albert_of_saxe-coburg_and_gotha	infectious_disease	children|cause_of_death
<e> 's kid 's father	charles_a_wickliffe	charles_a_wickliffe	children|parents
<e> 's spouse 's sex	jeanne_ii_countess_of_burgundy	male	spouse|gender
the profession of mom of <e>	george_grossmith_jr	novelist|singer	parents|profession
where did <e> 's mom die	mihailo_obrenovic_iii_prince_of_serbia	belgrade	parents|place_of_death
please tell me <e> 's son present address	frederick_william_i_of_prussia	berlin	children|location
what is the organization of <e> 's parent	taufaahau_tupou_iv	new_zealand	parents|institution
what is the race of offspring of <e>	artavasdes_i_of_armenia	armenians	children|ethnicity
the sex of <e> 's wife	mae_west	male	spouse|gender
what is the nationality of darling of <e>	carole_lombard	united_states	spouse|nationality
the kid of <e> 's offspring	yongzheng_emperor	jiaqing_emperor	children|children
what is the sex of kid of <e>	chindasuinth	male	children|gender
which nationality is <e> 's spouse	roger_needham	united_kingdom	spouse|nationality
what is the heir of <e> 's mom	felipe_prospero_of_habsburg	john_of_austria_the_younger	parents|children
the institution of mom of <e>	rasmus_bartholin	university_of_copenhagen	parents|institution
the ethnicity of child of <e>	major_ridge	cherokee|native_americans_in_the_united_states	children|ethnicity
what is the address of <e> 's son	frederick_william_i_of_prussia	berlin	children|location
what religious belief does <e> 's parents follow	mihrimar	islam	parents|religion
what is the profession of <e> 's dad	louis_the_pious	emperor	parents|profession
what is the <e> 's mother 's nation	henry_howard_7th_duke_of_norfolk	kingdom_of_england|england	parents|nationality
what is the <e> 's heir 's race	major_ridge	cherokee|native_americans_in_the_united_states	children|ethnicity
<e> 's couple 's profession	madhubala	singer	spouse|profession
what is the <e> 's wife 's occupation	verina	eastern_roman_emperor	spouse|profession
where does <e> 's other half work	caroline_webster_schermerhorn_astor	columbia_university	spouse|institution
what is the sex of <e> 's darling	lovisa_of_sweden	male	spouse|gender
the sex of dad of <e>	lady_cynthia_mosley	female	parents|gender
what is the son of parents of <e>	niels_bohr	harald_bohr	parents|children
what is the nationality of <e> 's wife	ina_claire	united_states	spouse|nationality
what is the sex of <e> 's mother	techichpotzin	male	parents|gender
which nationality is <e> 's child	edmund_stafford_5th_earl_of_stafford	kingdom_of_england	children|nationality
what is the sex of son of <e>	maximilian_i_of_bavaria	male	children|gender
what sex is <e> 's dad	robert_i_duke_of_burgundy	male	parents|gender
<e> 's heir 's nationality	philip_v_of_spain	portugal	children|nationality
what is the <e> 's son 's parent	augusta_of_saxe-weimar	william_i_german_emperor	children|parents
what is the nationality of <e> 's spouse	margaret_of_artois	france	spouse|nationality
what is the nation of <e> 's dad	george_grossmith_jr	england	parents|nationality
what is the <e> 's couple 's heir	maria_luisa_of_savoy	mariana_victoria_of_spain	spouse|children
the sex of <e> 's child	jewna	male	children|gender
what caused the <e> 's couple 's death	madhubala	cardiovascular_disease	spouse|cause_of_death
what is the gender of <e> 's dad	henry_cromwell	female	parents|gender
what is the kid of parents of <e>	qianlong_emperor	qianlong_emperor	parents|children
the address of <e> 's son	frederick_william_i_of_prussia	berlin	children|location
is <e> 's other half a man or a woman	irina_godunova	male	spouse|gender
what is <e> 's daughter 's race about	marvin_pentz_gay_sr	african_american	children|ethnicity
what is the sex of <e> 's mother	postumus_junior	male	parents|gender
what is <e> 's couple 's ethnicity like	george_tabori	swedish_american|swedish_people	spouse|ethnicity
<e> 's darling 's place of death	anna_lee	santa_barbara	spouse|place_of_death
where does <e> 's mom come from	philip_iii_of_navarre	france	parents|nationality
is <e> 's offspring a man or a woman	sherman_hoar	male	children|gender
<e> 's offspring 's occupation	frances_polidori	illustrator	children|profession
what gender is <e> 's daughter	joseph_p_kennedy_sr	female	children|gender
<e> 's parents 's sex	princess_sophia_dorothea_of_prussia	male	parents|gender
the nation of <e> 's dad	george_grossmith_jr	england	parents|nationality
what is the nation of <e> 's mother	henry_howard_7th_duke_of_norfolk	kingdom_of_england|england	parents|nationality
how <e> 's darling died	ida_lupino	lung_cancer	spouse|cause_of_death
which nationality is <e> 's daughter	roy_thomson_1st_baron_thomson_of_fleet	canada	children|nationality
<e> 's husband 's gender	samuel_pepys	female	spouse|gender
what is the <e> 's kid 's gender	louis_xvi_of_france	female	children|gender
<e> 's parents 's dad	prince_joachim_of_prussia	frederick_iii_german_emperor	parents|parents
<e> 's wife 's sex	mae_west	male	spouse|gender
what is the nationality of <e> 's kid	hortense_de_beauharnais	france	children|nationality
<e> 's daughter 's profession	john_a_roebling	engineer	children|profession
the parent of couple of <e>	noble_consort_wan	yongzheng_emperor	spouse|parents
what is the <e> 's couple 's profession	madhubala	singer	spouse|profession
what is the <e> 's children 's place of birth	archduchess_maria_beatrix_of_austria_este	ljubljana	children|place_of_birth
what is the heir of mom of <e>	jenny_longuet	jenny_longuet	parents|children
what sex is <e> 's couple	chilperic_i	female	spouse|gender
what is the wife of dad of <e>	henry_ii_of_england	henry_v_holy_roman_emperor	parents|spouse
what is the <e> 's children 's nation	james_otis_sr	united_states	children|nationality
what sex is <e> 's husband	matilda_of_flanders	male	spouse|gender
what did <e> 's dad die from	lynn_redgrave	parkinsons_disease	parents|cause_of_death
what is the religion of heir of <e>	louis_ix_of_france	catholicism	children|religion
the gender of mother of <e>	anne_of_cleves	male	parents|gender
the organization of other half of <e>	laura_devon	university_of_notre_dame|university_of_michigan	spouse|institution
what did <e> 's husband die from	evelyn_keyes	diabetes_mellitus	spouse|cause_of_death
what is the name of the kid of <e> 's offspring	yongzheng_emperor	jiaqing_emperor	children|children
what is the name of the grandheir of <e>	christiane_eberhardine_of_brandenburg_bayreuth	marie_josephe_of_saxony	children|children
what is the <e> 's children 's place of death	ahaz	jerusalem	children|place_of_death
what is the religious belief of <e> 's spouse	cecilia_renata_of_austria	catholicism	spouse|religion
what is the sex of <e> 's offspring	maria_of_spain	male	children|gender
<e> 's children 's nation	frank_lloyd_wright	united_states	children|nationality
what is the son of kid of <e>	alexandre_vicomte_de_beauharnais	napoleon_iii_of_france	children|children
the gender of <e> 's children	prince_alexander_of_hesse_and_by_rhine	male	children|gender
which nationality is <e> 's heir	gustaf_vi_adolf_of_sweden	sweden	children|nationality
what is the child of <e> 's parent	prince_feodor_alexandrovich_of_russia	prince_andrei_alexandrovich_of_russia	parents|children
the ethnicity of <e> 's mom	cleopatra_selene	greeks_in_egypt	parents|ethnicity
<e> 's other half 's gender	grand_duchess_elizabeth_mikhailovna	male	spouse|gender
the heir of mother of <e>	diego_colon	fernando_colon	parents|children
<e> 's parents 's sex	otto_i_duke_of_saxony	male	parents|gender
what is the <e> 's darling 's wife	elizabeth_of_york	elizabeth_of_york	spouse|spouse
what made the <e> 's spousedead	phillip_terry	pancreatic_cancer	spouse|cause_of_death
<e> 's darling 's nation	alva_belmont	united_states	spouse|nationality
what is the <e> 's mom 's spouse	saovabha	mongkut	parents|spouse
what is the name of the grandmother of <e>	marguerite_of_france	henry_iii_duke_of_brabant	parents|parents
what does <e> 's dad do for a living	louis_the_pious	emperor	parents|profession
what is <e> 's wife working on	ernest_hemingway	journalist	spouse|profession
what is the father of <e> 's other half	infanta_maria_de_la_paz_of_spain	infanta_amelia_philippina_of_spain	spouse|parents
what is the institution of <e> 's kid	anton_philips	delft_university_of_technology	children|institution
<e> 's son 's job	john_b_kelly_sr	fashion_model	children|profession
what gender is <e> 's dad	henry_cromwell	female	parents|gender
what is the gender of <e> 's mom	mieszko_iv_tanglefoot	male	parents|gender
what is the nationality of wife of <e>	marie-anne_pierrette_paulze	united_kingdom|germany	spouse|nationality
<e> 's kid 's gender	anton_philips	male	children|gender
the gender of <e> 's mother	pearl_starr	female	parents|gender
what is the nationality of daughter of <e>	john_spencer_churchill_7th_duke_of_marlborough	united_kingdom|england	children|nationality
the parents of daughter of <e>	thomas_thynne_2nd_viscount_weymouth	thomas_thynne_2nd_viscount_weymouth	children|parents
the other half of <e> 's other half	alexander_darcy	alexander_darcy	spouse|spouse
what is the daughter of <e> 's parents	infante_joao_of_portugal	infanta_isabel_duchess_of_burgundy	parents|children
what faith is <e> 's offspring	hermann_einstein	jew	children|religion
what is the mom of darling of <e>	georg_donatus_hereditary_grand_duke_of_hesse	prince_andrew_of_greece_and_denmark	spouse|parents
the race of darling of <e>	margaret_sullavan	jew	spouse|ethnicity
what is the sex of offspring of <e>	maria_fyodorovna_of_russia	female	children|gender
the place of death of children of <e>	ahaz	jerusalem	children|place_of_death
the place of birth of <e> 's mom	adolphus_busch_iii	st_louis_missouri	parents|place_of_birth
what is <e> 's child working on	anne_of_denmark	poet	children|profession
<e> 's heir 's gender	charles_i_of_england	female	children|gender
who is the grandson of <e>	j_presper_eckert	j_presper_eckert	children|children
<e> 's children 's institution	roy_thomson_1st_baron_thomson_of_fleet	upper_canada_college	children|institution
<e> 's wife 's cause of death	franz_joseph_i_of_austria	assassination	spouse|cause_of_death
what is the name of the darling of <e> 's husband	robert_e_lee	robert_e_lee	spouse|spouse
what is the daughter of <e> 's spouse	noble_consort_wan	jiaqing_emperor	spouse|children
what does <e> 's parents do	j_p_morgan_jr	financier	parents|profession
the kid of father of <e>	princess_tenagnework	princess_tsehai	parents|children
where is <e> 's heir staying	hermann_einstein	italy	children|location
the profession of child of <e>	gheorghe_i_tasca	politician	children|profession
what is the son of <e> 's parent	thomas_thynne_1st_marquess_of_bath	thomas_thynne_1st_marquess_of_bath	parents|children
<e> 's daughter 's work	alexandra_fyodorovna_of_hesse	grand_duchess	children|profession
the religion of <e> 's spouse	edwin_samuel_montagu	judaism	spouse|religion
what is the husband of <e> 's husband	james_hepburn_4th_earl_of_bothwell	francis_ii_of_france	spouse|spouse
who is the offspring of <e> 's dad	william_ii_german_emperor	princess_charlotte_of_prussia	parents|children
what does <e> 's offspring do for a living	frances_polidori	illustrator	children|profession
what is the <e> 's children 's profession	william_talbot	politician|lawyer	children|profession
what is the <e> 's dad 's sex	princess_elizabeth_of_england	female	parents|gender
<e> 's kid 's profession	sigurd_ibsen	film_director|screenwriter	children|profession
the cause of death of husband of <e>	virginia_heinlein	emphysema	spouse|cause_of_death
the child of <e> 's parent	thomas_spurgeon	thomas_spurgeon	parents|children
what is the <e> 's heir 's religion	louis_ix_of_france	catholicism	children|religion
what is the gender of <e> 's husband	martha_bulloch	male	spouse|gender
the religion of <e> 's other half	madhubala	hinduism	spouse|religion
what is the <e> 's wife 's father	aelia_eudoxia	theodosius_i	spouse|parents
the sex of <e> 's daughter	william_of_winchester_lord_of_lunenburg	male	children|gender
what is the <e> 's parent 's location	george_darwin	shrewsbury	parents|location
what is the <e> 's child 's nationality	leonard_jerome	united_states	children|nationality
what is the gender of <e> 's darling	louise_juliana_of_nassau	male	spouse|gender
where does <e> 's parent come from	edward_of_norwich_2nd_duke_of_york	kingdom_of_england	parents|nationality
what is the parents of heir of <e>	charles_lennox_1st_duke_of_richmond	charles_lennox_1st_duke_of_richmond	children|parents
what is the name of the husband of <e> 's son	marie_of_edinburgh	archduke_anton_prince_of_tuscany	children|spouse
the profession of <e> 's parents	j_p_morgan_jr	financier	parents|profession
what is the <e> 's daughter 's nation	nathan_mayer_rothschild	united_kingdom	children|nationality
the sex of offspring of <e>	sherman_hoar	male	children|gender
what is the name of the grandchild of <e>	francis_i_of_france	charles_ix_of_france	children|children
the children of offspring of <e>	jahangir	dara_shikoh	children|children
the gender of other half of <e>	benjamin_harrison	female	spouse|gender
which nationality is <e> 's parent	ramon_berenguer_i_count_of_barcelona	spain	parents|nationality
is <e> 's offspring a man or a woman	charles_lennox_1st_duke_of_richmond	male|female	children|gender
the sex of <e> 's husband	grand_duke_peter_nicolaievich_of_russia	female	spouse|gender
what is the couple of <e> 's couple	julie_london	julie_london	spouse|spouse
what is the children of mother of <e>	henry_i_duke_of_guise	charles_of_lorraine_duke_of_mayenne	parents|children
<e> 's daughter 's location	john_elector_of_saxony	coburg	children|location
the place of death of parents of <e>	princess_margaret_of_prussia	potsdam	parents|place_of_death
what is the spouse of <e> 's husband	mary_anna_custis_lee	mary_anna_custis_lee	spouse|spouse
what is the place of death of heir of <e>	francis_iv_duke_of_modena	graz	children|place_of_death
what is <e> 's couple working on	madhubala	singer	spouse|profession
what is the work of <e> 's father	mette_marit_crown_princess_of_norway	journalist	parents|profession
who is the granddaughter of <e>	marguerite_of_france	elizabeth_of_rhuddlan	children|children
what sex is <e> 's dad	lothair_of_france	female	parents|gender
what gender is <e> 's kid	sarah_lennox_duchess_of_richmond	male	children|gender
what is the type of religion of <e> 's heir	alice_betty_stern	jew	children|religion
what is the <e> 's spouse 's gender	helena_of_moscow	male	spouse|gender
what is <e> 's son 's birthplace	ferdinand_maria_elector_of_bavaria	munich	children|place_of_birth
what is the daughter of <e> 's dad	princess_sophia_dorothea_of_prussia	frederick_ii_of_prussia	parents|children
the place of death of <e> 's darling	elizabeth_allan_1908	new_york	spouse|place_of_death
the gender of darling of <e>	franz_joseph_i_of_austria	female	spouse|gender
the job of <e> 's kid	thomas_thynne_2nd_viscount_weymouth	politician	children|profession
<e> 's darling 's gender	richard_mulligan	female	spouse|gender
what is the <e> 's child 's nationality	john_d_rockefeller_jr	united_states	children|nationality
what is the <e> 's other half 's gender	irina_godunova	male	spouse|gender
the profession of <e> 's wife	alexander_darcy	actor	spouse|profession
what gender is <e> 's mother	philip_ii_of_taranto	male	parents|gender
what does <e> 's husband do	colleen_dewhurst	actor	spouse|profession
the nation of <e> 's spouse	margaret_sullavan	france	spouse|nationality
the father of <e> 's daughter	louis_iv_of_france	gerberga_of_saxony	children|parents
the parent of parents of <e>	william_kissam_vanderbilt	cornelius_vanderbilt	parents|parents
what is the gender of child of <e>	john_v_palaiologos	male	children|gender
<e> 's children 's sex	francis_ii_holy_roman_emperor	female	children|gender
where did <e> 's son die	francis_i_of_france	paris	children|place_of_death
who is the child of <e> 's child	albert_of_saxe-coburg_and_gotha	victoria_eugenia_of_battenberg|prince_maurice_of_battenberg	children|children
what is the <e> 's parent 's race	simeon_uro	serbs	parents|ethnicity
the son of <e> 's parent	archduke_louis_of_austria	rudolf_cardinal_von_habsburg_lothringen|archduke_joseph_of_austria_palatine_of_hungary	parents|children
what is the mom of <e> 's darling	georg_donatus_hereditary_grand_duke_of_hesse	prince_andrew_of_greece_and_denmark	spouse|parents
what is the organization of other half of <e>	laura_devon	university_of_notre_dame|university_of_michigan	spouse|institution
what is the <e> 's offspring 's work	cosima_wagner	conducting|composer	children|profession
the nationality of wife of <e>	anne_of_york	england	spouse|nationality
the nationality of <e> 's heir	philip_v_of_spain	portugal	children|nationality
what is <e> 's mom 's birthplace	henry_iii_of_france	florence	parents|place_of_birth
what sex is <e> 's mother	hussein_of_jordan	male	parents|gender
what is the <e> 's parent 's nation	david_carradine	united_states	parents|nationality
what is the <e> 's children 's job	princess_margaret_of_connaught	prince	children|profession
what is the nation of son of <e>	princess_beatrice_of_the_united_kingdom	united_kingdom	children|nationality
<e> 's other half 's wife	arleen_whelan	arleen_whelan	spouse|spouse
what is the sex of children of <e>	marguerite_of_france	female	children|gender
what is the nationality of spouse of <e>	roger_needham	united_kingdom	spouse|nationality
what line of business is <e> 's dad in	anna_e_roosevelt	social_activist	parents|profession
what is the <e> 's darling 's educational institution	effie_gray	christ_church_oxford	spouse|institution
what is <e> 's heir 's birthplace	jawaharlal_nehru	allahabad	children|place_of_birth
the gender of <e> 's heir	jahangir	male	children|gender
what is the name of the couple of <e> 's kid	alice_spencer	henry_hastings_5th_earl_of_huntingdon	children|spouse
what religion is <e> 's spouse	edwin_samuel_montagu	judaism	spouse|religion
what is the <e> 's son 's nationality	frederick_william_i_of_prussia	germany	children|nationality
what is the nationality of <e> 's son	frederick_william_i_of_prussia	germany	children|nationality
<e> 's parents 's gender	andrey_bolshoy	male	parents|gender
the religion of <e> 's father	george_darwin	anglicanism|agnosticism	parents|religion
what gender is <e> 's kid	henrietta_anne_stuart	female	children|gender
<e> 's offspring 's place of death	maria_theresa_of_austria	vienna	children|place_of_death
is <e> 's children a man or a woman	francis_ii_holy_roman_emperor	female	children|gender
what is the spouse of <e> 's mom	henry_i_duke_of_guise	jacques_de_savoie_2nd_duc_de_nemours	parents|spouse
the father of daughter of <e>	ellen_terry	edward_william_godwin	children|parents
who is the grandmother of <e>	christian_ii_of_denmark	dorothea_of_brandenburg	parents|parents
what type of religion does <e> 's wife follow	james_hepburn_4th_earl_of_bothwell	catholicism	spouse|religion
<e> 's heir 's husband	philip_v_of_spain	joseph_i_of_portugal	children|spouse
<e> 's children 's gender	prince_alexander_of_hesse_and_by_rhine	male	children|gender
where does <e> 's child come from	leonard_jerome	united_states	children|nationality
what is the sex of dad of <e>	constantine_xi	male	parents|gender
where does <e> 's children come from	marguerite_of_france	england	children|nationality
the gender of heir of <e>	henry_ii_of_france	male	children|gender
what is the <e> 's son 's cause of death	anton_philips	accidental_fall	children|cause_of_death
which organization does <e> 's parent work for	taufaahau_tupou_iv	new_zealand	parents|institution
the nation of <e> 's dad	frank_reicher	germany	parents|nationality
is <e> 's heir a man or a woman	leopold_ii_holy_roman_emperor	male	children|gender
where does <e> 's darling work for	juliette_peirce	harvard_university	spouse|institution
what is the <e> 's other half 's gender	samuel_gridley_howe	male|female	spouse|gender
what line of business is <e> 's children in	william_talbot	politician|lawyer	children|profession
what is the <e> 's darling 's nation	margaret_mead	united_states	spouse|nationality
the place of death of offspring of <e>	augustus_ii_the_strong	avignon	children|place_of_death
what did <e> 's father die from	prince_joachim_of_prussia	pulmonary_embolism	parents|cause_of_death
the nation of <e> 's wife	robert_anderson_1917	united_states	spouse|nationality
what is the <e> 's kid 's gender	frank_lloyd_wright	male	children|gender
what is the sex of <e> 's other half	juba_ii	female	spouse|gender
what is the gender of offspring of <e>	artavasdes_i_of_armenia	male	children|gender
what is the institution of darling of <e>	juliette_peirce	harvard_university	spouse|institution
what is the cause of death of <e> 's kid	nicholas_ii_of_russia	murder|firearm	children|cause_of_death
<e> 's couple 's work	arthur_de_wint_foote	writer	spouse|profession
what city did <e> 's mom die	mihailo_obrenovic_iii_prince_of_serbia	belgrade	parents|place_of_death
<e> 's husband 's sex	henrietta_anne_stuart	male	spouse|gender
what is the <e> 's child 's gender	henry_iii_holy_roman_emperor	male	children|gender
what is the name of the heir of <e> 's mother	frits_philips	frits_philips	parents|children
<e> 's mom 's daughter	leonora_of_england	geoffrey_ii_duke_of_brittany	parents|children
<e> 's parent 's nation	edward_ellice_1810	united_kingdom	parents|nationality
what is the child of wife of <e>	charles_i_duke_of_burgundy	mary_of_burgundy	spouse|children
what faith is <e> 's son	christiane_eberhardine_of_brandenburg_bayreuth	catholicism	children|religion
where did <e> 's offspring die	archduchess_maria_beatrix_of_austria_este	varese	children|place_of_death
which city did <e> 's mom born	henry_iii_of_france	florence	parents|place_of_birth
what caused the <e> 's other half 's death	adolf_hitler	suicide|cyanide_poisoning	spouse|cause_of_death
what is the sex of <e> 's children	marguerite_of_france	female	children|gender
what is the <e> 's spouse 's nation	bettye_ackerman	united_states	spouse|nationality
the gender of <e> 's mother	philip_ii_of_taranto	male	parents|gender
what sex is <e> 's kid	chindasuinth	male	children|gender
what is the place of death of daughter of <e>	george_iii_of_the_united_kingdom	windsor_castle	children|place_of_death
what is the <e> 's mom 's daughter	laura_marx	jenny_longuet	parents|children
what is <e> 's mom working on	george_grossmith_jr	novelist|singer	parents|profession
what is the sex of <e> 's darling	colleen_dewhurst	male	spouse|gender
the sex of <e> 's darling	joseph_e_davies	female	spouse|gender
the place of birth of <e> 's children	archduchess_maria_beatrix_of_austria_este	ljubljana	children|place_of_birth
what killed the <e> 's other half	adolf_hitler	suicide|cyanide_poisoning	spouse|cause_of_death
please tell me <e> 's daughter present address	john_elector_of_saxony	coburg	children|location
the nation of couple of <e>	julie_london	united_states	spouse|nationality
what is the sex of parent of <e>	penelope_blount_countess_of_devonshire	male	parents|gender
what sex is <e> 's parents	ludwig_ii_of_bavaria	male	parents|gender
what sex is <e> 's child	david_kawananakoa	female	children|gender
what faith does <e> 's husband follow	marie-anne_pierrette_paulze	anglicanism	spouse|religion
what is the <e> 's father 's son	charles_duke_of_lower_lorraine	lothair_of_france	parents|children
what is the gender of parent of <e>	princess_margaret_of_prussia	male	parents|gender
the mother of <e> 's son	william_starling_burgess	william_starling_burgess	children|parents
the nationality of child of <e>	grand_duke_michael_mihailovich_of_russia	united_kingdom	children|nationality
what made the <e> 's daddead	justinus_van_nassau	assassination|firearm	parents|cause_of_death
<e> 's mom 's nationality	george_formby	england	parents|nationality
why <e> 's dad died	louise_juliana_of_nassau	assassination|firearm	parents|cause_of_death
what is the sex of darling of <e>	luis_munoz_marin	female	spouse|gender
what is the race of <e> 's parent	chagatai_khan	mongols	parents|ethnicity
what is the sex of <e> 's wife	huey_long	female	spouse|gender
<e> 's child 's gender	augusta_viktoria_of_schleswig-holstein	male	children|gender
the nation of spouse of <e>	luz_magsaysay	philippines	spouse|nationality
who is the grandmom of <e>	princess_amelia_sophia_of_great_britain	george_i_of_great_britain	parents|parents
what is the <e> 's daughter 's place of death	anne_marie_martinozzi	fontainebleau	children|place_of_death
the wife of dad of <e>	henry_ii_of_england	henry_v_holy_roman_emperor	parents|spouse
what is the <e> 's parents 's sex	tyrone_power	male	parents|gender
<e> 's couple 's nation	julie_london	united_states	spouse|nationality
is <e> 's father a man or a woman	frederick_v_of_denmark	female	parents|gender
what is the job of <e> 's child	sigurd_ibsen	film_director|screenwriter	children|profession
what is the <e> 's daughter 's parents	jenny_von_westphalen	jenny_von_westphalen	children|parents
what is the daughter of <e> 's parent	takelot_iii	takelot_iii	parents|children
what is the place of death of <e> 's kid	princess_beatrice_of_the_united_kingdom	lausanne	children|place_of_death
the son of child of <e>	j_presper_eckert	j_presper_eckert	children|children
the type of religion of dad of <e>	j_p_morgan_jr	anglicanism	parents|religion
the gender of spouse of <e>	ptolemy_ix_lathyros	female	spouse|gender
what is the gender of kid of <e>	frank_lloyd_wright	male	children|gender
the son of <e> 's child	j_presper_eckert	j_presper_eckert	children|children
is <e> 's heir a man or a woman	charles_i_of_england	female	children|gender
what is the sex of <e> 's son	archduchess_maria_beatrix_of_austria_este	male	children|gender
what is the name of the offspring of <e> 's offspring	grand_duchess_alexandra_petrovna	princess_nadejda_petrovna_of_russia	children|children
is <e> 's spouse a man or a woman	carlos_thompson	female	spouse|gender
what is the <e> 's parents 's gender	natalia_alexeievna_of_russia	female	parents|gender
what is <e> 's son working on	john_b_kelly_sr	fashion_model	children|profession
<e> 's couple 's sex	lew_cody	female	spouse|gender
what is the gender of <e> 's darling	empress_xiaoquan_cheng	male	spouse|gender
is <e> 's daughter a man or a woman	yaroslav_i_the_wise	male	children|gender
what does <e> 's heir do for a living	henry_iv_of_england	monarch	children|profession
how <e> 's dad died	justinus_van_nassau	assassination|firearm	parents|cause_of_death
<e> 's darling 's sex	samuel_gridley_howe	male|female	spouse|gender
the cause of death of dad of <e>	lynn_redgrave	parkinsons_disease	parents|cause_of_death
what is the occupation of <e> 's wife	verina	eastern_roman_emperor	spouse|profession
what is the <e> 's heir 's faith	jawaharlal_nehru	hinduism	children|religion
the sex of <e> 's parent	penelope_blount_countess_of_devonshire	male	parents|gender
what line of business is <e> 's child in	anne_of_denmark	poet	children|profession
which educational institution does <e> 's other half work for	caroline_webster_schermerhorn_astor	columbia_university	spouse|institution
what is the darling of other half of <e>	joseph_e_davies	joseph_e_davies	spouse|spouse
the parents of child of <e>	anton_philips	anton_philips	children|parents
what is the <e> 's son 's child	duke_peter_of_oldenburg	grand_duke_peter_nicolaievich_of_russia|grand_duke_nicholas_nicolaevich_the_younger	children|children
what is the sex of <e> 's children	michael_i_rangabe	male	children|gender
<e> 's kid 's sex	alexander_ferdinand_3rd_prince_of_thurn_and_taxis	male	children|gender
what is the gender of <e> 's children	princess_beatrice_of_the_united_kingdom	male	children|gender
what is the parent of son of <e>	anna_of_holstein-gottorp	enno_iii_count_of_ostfriesland	children|parents
what is the gender of <e> 's heir	jahangir	male	children|gender
what is the name of the grandparents of <e>	henry_iii_of_france	madeleine_de_la_tour_dauvergne	parents|parents
what is the couple of mom of <e>	sunandha	mongkut	parents|spouse
what is the gender of <e> 's parents	lady_louisa_stuart	male	parents|gender
what does <e> 's other half do for a living	elizabeth_of_york	monarch	spouse|profession
what gender is <e> 's son	charles_ii_of_austria	female	children|gender
the type of religion of <e> 's daughter	franz_josef_i_prince_of_liechtenstein	catholicism	children|religion
what is the work of kid of <e>	emperor_temmu	writer	children|profession
the daughter of parent of <e>	louis_of_bourbon_duke_of_orleans	duc_dorleans	parents|children
which nationality is <e> 's wife	anne_of_york	england	spouse|nationality
<e> 's parents 's nationality	edward_salisbury_dana	united_states	parents|nationality
what is the <e> 's mom 's nationality	vratislaus_ii_of_bohemia	germany	parents|nationality
what is the <e> 's darling 's nation	edwin_samuel_montagu	united_kingdom	spouse|nationality
the sex of parent of <e>	claudius	male	parents|gender
what is the nationality of children of <e>	marguerite_of_france	england	children|nationality
what is the <e> 's dad 's gender	frederick_edward_guest	male	parents|gender
what faith does <e> 's heir follow	jawaharlal_nehru	hinduism	children|religion
what is the <e> 's mom 's gender	george_formby	male	parents|gender
what did <e> 's daughter die from	albert_of_saxe-coburg_and_gotha	infectious_disease	children|cause_of_death
how <e> 's daughter died	albert_of_saxe-coburg_and_gotha	infectious_disease	children|cause_of_death
the nationality of other half of <e>	edward_blake	canada	spouse|nationality
what is <e> 's parent 's race like	chagatai_khan	mongols	parents|ethnicity
what is <e> 's spouse 's race about	elizabeth_de_burgh	scottish_people	spouse|ethnicity
what is the <e> 's darling 's ethnicity	george_tabori	swedish_american|swedish_people	spouse|ethnicity
what is <e> 's kid	cosima_wagner	conducting|composer	children|profession
the son of <e> 's father	maria_antonia_of_portugal	maria_josepha_of_portugal	parents|children
<e> 's offspring 's race	artavasdes_i_of_armenia	armenians	children|ethnicity
the educational institution of <e> 's darling	effie_gray	christ_church_oxford	spouse|institution
what is the sex of parents of <e>	otto_i_duke_of_saxony	male	parents|gender
the sex of child of <e>	wang_khan	female	children|gender
what is <e> 's parent	wladyslaw_czartoryski	politician	parents|profession
who is the heir of <e> 's couple	maria_luisa_of_savoy	mariana_victoria_of_spain	spouse|children
the ethnicity of <e> 's wife	noble_consort_wan	manchu	spouse|ethnicity
where does <e> 's husband work for	laura_devon	university_of_notre_dame|university_of_michigan	spouse|institution
is <e> 's son a man or a woman	charles_ii_of_austria	female	children|gender
the nationality of <e> 's mom	vratislaus_ii_of_bohemia	germany	parents|nationality
<e> 's mother 's sex	rasmus_bartholin	male	parents|gender
the sex of <e> 's heir	sylvia_likens	male	children|gender
the sex of <e> 's mother	niels_bohr	male	parents|gender
what is the sex of <e> 's other half	anna_radziwill	male	spouse|gender
<e> 's child 's institution	victoria_of_the_united_kingdom	trinity_college_cambridge	children|institution
the heir of mom of <e>	jenny_longuet	jenny_longuet	parents|children
<e> 's darling 's nationality	carole_lombard	united_states	spouse|nationality
what is the <e> 's children 's sex	marguerite_of_france	female	children|gender
what is the sex of <e> 's offspring	leonard_jerome	female	children|gender
<e> 's offspring 's sex	leonard_jerome	female	children|gender
what is the address of <e> 's children	augusta_viktoria_of_schleswig-holstein	potsdam	children|location
what city did <e> 's offspring die	maria_luisa_of_parma	trieste	children|place_of_death
where did <e> 's wife born	alice_of_bourbon_parma	florence	spouse|place_of_birth
the gender of father of <e>	mikolaj_vii_radziwill	female	parents|gender
what is the gender of <e> 's children	nicholas_ii_of_russia	female	children|gender
what is the <e> 's kid 's profession	marvin_pentz_gay_sr	composer|record_producer	children|profession
