emperor_temmu	children	empress_jito
adolf_hitler	profession	artist
mel_ferrer	gender	male
franz_josef_i_prince_of_liechtenstein	children	johann_i_josef_prince_of_liechtenstein
maximilian_i_of_bavaria	spouse	caroline_of_baden
charles_xv_of_sweden	gender	male
aurangzeb	children	bahadur_shah_i
eleanor_of_alburquerque	gender	female
nikephoros_ii	spouse	theophano
george_v_of_the_united_kingdom	children	prince_george_duke_of_kent
john_f_kennedy	institution	riverdale_country_school
isabella_of_france	nationality	kingdom_of_england
laura_marx	parents	jenny_von_westphalen
louis-philippe_of_france	children	louis_duke_of_nemours
kitiyakara_voralaksana	children	nakkhatra_mangkala_kitiyakara
charlie_soong	institution	vanderbilt_university
henry_iv_of_england	children	henry_v_of_england
sophia_eleonore_of_saxony	children	anna_sophia_ii_abbess_of_quedlinburg
charles_i_duke_of_burgundy	spouse	margaret_of_york
walter_rothschild_2nd_baron_rothschild	nationality	united_kingdom
maria_alexandrovna_of_russia	gender	female
john_ii_komnenos	gender	male
mori_motonari	location	aki_province
casimir_margrave_of_brandenburg_bayreuth	religion	lutheranism
james_otis	nationality	united_states
john_jacob_astor_iv	nationality	united_states
augusta_viktoria_of_schleswig-holstein	children	prince_august_wilhelm_of_prussia
assia_wevill	nationality	germany
thomas_spurgeon	parents	charles_spurgeon
jenny_longuet	parents	jenny_von_westphalen
manuel_i_komnenos	parents	john_ii_komnenos
pearl_starr	nationality	united_states
henri_i_de_bourbon_prince_de_conde	nationality	france
marie_josephe_of_saxony	place_of_death	versailles
ferdinand_vii_of_spain	children	isabella_ii_of_spain
mary_josephine_hannon_fitzgerald	nationality	united_states
tey	children	mutnedjmet
maria_josepha_of_portugal	children	elisabeth_of_bavaria_1876
gregory_bateson	nationality	united_states
louis_the_stammerer	parents	ermentrude_of_orleans
j_p_morgan_jr	profession	financier
henry_iv_holy_roman_emperor	place_of_death	liege
margaret_of_parma	spouse	ottavio_farnese_duke_of_parma
frederick_william_i_of_prussia	place_of_death	berlin
tasha_tudor	parents	william_starling_burgess
ferdinand_vi_of_spain	spouse	barbara_of_portugal
sigismund_iii_vasa	gender	male
george_grossmith	profession	novelist
lothair_of_france	parents	gerberga_of_saxony
louisa_ulrika_of_prussia	parents	frederick_william_i_of_prussia
henry_the_lion	parents	gertrud_of_supplingenburg
djedefra	parents	khufu
archduchess_marie_caroline_of_austria	gender	female
archduchess_luise_princess_of_tuscany	place_of_death	brussels
prince_heinrich_of_prussia	children	prince_waldemar_of_prussia_kiel
william_starling_burgess	children	tasha_tudor
charles_ii_of_naples	children	louis_of_toulouse
amschel_mayer_rothschild	gender	male
alva_belmont	spouse	oliver_belmont
ferdinand_duke_of_genoa	place_of_birth	florence
maria_christina_of_austria	parents	archduchess_elisabeth_franziska_of_austria
eugene_de_beauharnais	children	amelie_de_beauharnais_of_leuchtenberg
empress_matilda	spouse	henry_v_holy_roman_emperor
john_b_kelly_sr	place_of_death	philadelphia
sigurd_ibsen	children	tancred_ibsen
louis_xvi_of_france	ethnicity	french_people
bona_sforza	children	anna_jagiellon
benjamin_peirce	children	charles_peirce
louise_of_mecklenburg-strelitz	children	princess_alexandrine_of_prussia
lillian_lux	spouse	pesach_burstein
leopold_ii_holy_roman_emperor	children	rudolf_cardinal_von_habsburg_lothringen
grace_kelly	spouse	rainier_iii_prince_of_monaco
adolph_b_spreckels	location	san_francisco
charles_xiv_john_of_sweden	religion	christianity
chagatai_khan	parents	genghis_khan
svante_nilsson	gender	male
louise_juliana_of_nassau	spouse	frederick_iv_elector_palatine
ludwig_i_of_bavaria	children	otto_of_greece
william_iv_of_the_united_kingdom	spouse	adelaide_of_saxe-meiningen
adelaide_of_aquitaine	children	robert_ii_of_france
margaret_plantagenet	parents	eleanor_of_castile
marguerite_duchess_of_orleans	parents	francis_ii_duke_of_lorraine
ay	gender	male
leopold_i_duke_of_austria	parents	albert_i_of_germany
mark_antony	children	antonia_major
skip_caray	parents	harry_caray
archduke_franz_ferdinand_of_austria	place_of_birth	graz
bertrade_de_montfort	spouse	fulk_iv_of_anjou
prince_leopold_of_bavaria	gender	male
urraca_princess_of_castile	gender	female
william_petty_2nd_earl_of_shelburne	location	county_dublin
theobald_ii_of_champagne	parents	stephen_ii_count_of_blois
rainier_iii_prince_of_monaco	place_of_birth	monaco
maria_amalia_of_saxony	children	charles_iv_of_spain
frederick_iii_german_emperor	children	princess_charlotte_of_prussia
luigi_amedeo_duke_of_the_abruzzi	profession	mountaineering
charles_ii_grand_duke_of_mecklenburg_strelitz	nationality	germany
louis_ix_of_france	nationality	france
bobby_troup	nationality	united_states
magdolna_purgly	spouse	miklos_horthy
princess_sibylla_of_saxe-coburg_and_gotha	spouse	prince_gustav_adolf_duke_of_vasterbotten
louie_bellson	gender	male
maria_amalia_of_austria	nationality	austria
anna_e_roosevelt	profession	writer
gaston_duke_of_orleans	gender	male
john_f_kennedy	institution	choate_rosemary_hall
grand_duke_vyacheslav_konstantinovich_of_russia	parents	alexandra_iosifovna_of_altenburg
frederick_wilhelm_duke_of_saxe_meiningen	nationality	germany
artie_shaw	profession	composer
vittorio_emanuele_count_of_turin	parents	amadeo_i_of_spain
sigismund_iii_vasa	children	john_albert_vasa
irina_godunova	spouse	feodor_i_of_russia
jovian	parents	constantius_ii
grand_duke_konstantin_nikolayevich_of_russia	children	grand_duke_dmitri_konstantinovich_of_russia
charles_xiv_john_of_sweden	location	aquitaine
princess_hildegard_of_bavaria	parents	therese_of_saxe_hildburghausen
maria_winteler_einstein	gender	female
benjamin_disraeli_1st_earl_of_beaconsfield	ethnicity	jew
john_campbell_9th_duke_of_argyll	institution	trinity_college_cambridge
gilbert_talbot_7th_earl_of_shrewsbury	parents	george_talbot_6th_earl_of_shrewsbury
edmund_stafford_5th_earl_of_stafford	children	thomas_bourchier
count_alexei_alexandrovich_belevsky_zhukovsky	parents	alexandra_vasilievna_countess_zhukavskaya
ferdinand_i_holy_roman_emperor	profession	holy_roman_emperor
francis_i_holy_roman_emperor	profession	emperor
mary_of_teck	children	prince_george_duke_of_kent
soong_may-ling	children	chiang_wei-kuo
augusta_viktoria_of_schleswig-holstein	nationality	germany
isabel_de_clare_4th_countess_of_pembroke	parents	richard_de_clare_2nd_earl_of_pembroke
duchess_sophie_charlotte_augustine_in_bavaria	children	princess_louise_victoire_dorleans_alencon
albert_kamehameha	parents	queen_emma_of_hawaii
joan_hackett	profession	actor
george_darwin	profession	mathematician
muhammad_al-mahdi	parents	hasan_al-askari
jahangir	religion	islam
susanna_of_bavaria	place_of_birth	ansbach
richard_de_clare_2nd_earl_of_pembroke	spouse	eva_macmurrough
thomas_howard_3rd_duke_of_norfolk	nationality	england
mabel_normand	gender	female
simone_signoret	nationality	france
alfonso_de_orleans_y_borbon	gender	male
anne_of_denmark	children	elizabeth_of_bohemia
paul_newman	institution	kenyon_college
cleopatra_vii_of_egypt	children	alexander_helios
jewna	children	algirdas
henry_vii_of_england	place_of_birth	pembroke_castle
sviatoslav_ii_of_kiev	gender	male
henry_ii_of_france	children	francois_duke_of_anjou
constantine_i	religion	christianity
geoffrey_ii_duke_of_brittany	children	arthur_i_duke_of_brittany
philip_iv_of_france	spouse	joan_i_of_navarre
john_d_spreckels	profession	businessperson
mae_west	institution	erasmus_hall_high_school
maria_teresa_of_the_two_sicilies	gender	female
julius_caesar_drusus	place_of_birth	rome
princess_victoria_melita_of_edinburgh_and_saxe-coburg-gotha	gender	female
henry_viii_of_england	spouse	catherine_parr
auguste_van_pels	spouse	hermann_van_pels
beatrice_deste	spouse	ludovico_sforza
prince_konrad_of_bavaria	parents	prince_leopold_of_bavaria
napoleon_ii_of_france	nationality	france
martha_bulloch	spouse	theodore_roosevelt_sr
james_smithson	parents	hugh_percy_1st_duke_of_northumberland
blanche_of_lancaster	nationality	england
norman_frank_wilson	nationality	canada
richard_burton	gender	male
abigail_campbell_kawananakoa	place_of_death	honolulu
isabella_of_jerusalem	parents	amalric_i_of_jerusalem
postumus	gender	male
constantine_xi	gender	male
philippine_elisabeth_of_orleans	parents	philippe_ii_duke_of_orleans
philip_v_of_spain	children	mariana_victoria_of_spain
j_presper_eckert	profession	electrical_engineer
stefan_uro_iii_de_anski_of_serbia	ethnicity	serbs
john_of_gaunt_1st_duke_of_lancaster	children	philippa_of_lancaster
fred_perry	spouse	helen_vinson
princess_amalie_auguste_of_bavaria	children	albert_i_of_saxony
william_h_seward	nationality	united_states
domhnall_of_islay_lord_of_the_isles	parents	john_of_islay_lord_of_the_isles
marie_francois_sadi_carnot	gender	male
john_viii_palaiologos	gender	male
princess_mary_of_great_britain	children	prince_frederick_of_hesse
isabella_of_angouleme	children	isabella_of_england
allison_defeo	place_of_death	amityville
lucius_verus	parents	lucius_aelius
peter_sellers	place_of_death	london
mary_welsh_hemingway	profession	journalist
blanche_i_of_navarre	gender	female
prince_valdemar_of_denmark	place_of_death	copenhagen
alfonso_x_of_castile	nationality	spain
eleanor_roosevelt	gender	female
prince_joseph_clemens_of_bavaria	gender	male
sarah	spouse	abraham
ramon_berenguer_i_count_of_barcelona	spouse	almodis_de_la_marche
charles_i_duke_of_burgundy	spouse	isabella_of_bourbon
robert_stevenson_1905	place_of_death	santa_barbara
mehmed_vi	place_of_death	sanremo
theophanu	children	otto_iii_holy_roman_emperor
anne_marie_of_orleans	children	maria_luisa_of_savoy
eleanor_of_castile	children	elizabeth_of_rhuddlan
karl_ludwig_of_baden	children	louise_of_baden
george_grossmith_jr	profession	singer
charles_v_holy_roman_emperor	children	joan_of_habsburg
prince_augustus_william_of_prussia	parents	frederick_william_i_of_prussia
lord_randolph_churchill	nationality	united_kingdom
cecilia_renata_of_austria	spouse	wladyslaw_iv_vasa
lili_damita	cause_of_death	alzheimers_disease
marie_antoinette	children	louis_xvii_of_france
louise_marie_anne_de_bourbon	parents	louis_xiv_of_france
amenhotep_iii	gender	male
louis_xiv_of_france	parents	anne_of_austria
charles_lennox_2nd_duke_of_richmond	gender	male
dorothy_davenport	parents	harry_davenport
bettye_ackerman	spouse	sam_jaffe_1891
juan_prince_of_asturias	nationality	spain
prince_konrad_of_bavaria	gender	male
louis_iv_of_france	children	lothair_of_france
carlos_duke_of_madrid	place_of_death	varese
benedita_dowager_princess_of_brazil	parents	mariana_victoria_of_spain
john_lennon	religion	atheism
lady_anne_cavendish_bentinck	gender	female
francis_ii_holy_roman_emperor	children	archduchess_marie_caroline_of_austria
louis_iii_prince_of_conde	parents	henry_iii_jules_de_bourbon_prince_de_conde
princess_leopoldina_of_brazil	parents	pedro_ii_of_brazil
frederick_ii_of_prussia	nationality	germany
john_gilbert_1899	nationality	united_states
marvin_gaye	cause_of_death	firearm
bernhard_i_duke_of_saxe_meiningen	children	frederick_wilhelm_duke_of_saxe_meiningen
bezmialem	religion	eastern_orthodox_church
arcadius	parents	theodosius_i
herod_the_great	children	herod_archelaus
louise_of_mecklenburg-strelitz	children	prince_charles_of_prussia
princess_margaret_of_prussia	gender	female
prince_george_duke_of_kent	parents	mary_of_teck
princess_beatrice_of_the_united_kingdom	parents	victoria_of_the_united_kingdom
hulagu_khan	children	abaqa_khan
robert_anderson_1917	spouse	teresa_wright
charles_iv_holy_roman_emperor	children	anne_of_bohemia
jeanne_devreux	place_of_death	brie-comte-robert
charles_spurgeon	children	thomas_spurgeon
prince_francis_of_teck	nationality	united_kingdom
john_f_kennedy_jr	place_of_death	atlantic_ocean
simone_signoret	spouse	yves_montand
hermenegild	children	artabastos
umberto_i_of_italy	cause_of_death	tyrannicide
james_henry_hackett	children	james_keteltas_hackett
eulalia_duchess_of_galliera	children	alfonso_de_orleans_y_borbon
thursday_october_christian_ii	parents	thursday_october_christian_i
gustaf_vi_adolf_of_sweden	children	prince_gustav_adolf_duke_of_vasterbotten
archduke_franz_karl_of_austria	parents	maria_teresa_of_the_two_sicilies
princess_elisabeth_maria_of_bavaria	parents	prince_alfons_of_bavaria
tigranes_the_great	gender	male
elem_klimov	spouse	larisa_shepitko
geraldine_apponyi_de_nagy-apponyi	place_of_death	tirana
william_shakespeare	nationality	england
marie-anne_pierrette_paulze	spouse	benjamin_thompson
pieter_brueghel_the_elder	children	pieter_brueghel_the_younger
octavia_minor	place_of_birth	nola
hezekiah	place_of_death	jerusalem
jacques_de_savoie_2nd_duc_de_nemours	spouse	anna_deste
jacqueline_kennedy_onassis	institution	georgetown_university
george_iii_of_the_united_kingdom	children	george_iv_of_the_united_kingdom
abigail_campbell_kawananakoa	children	abigail_kapiolani_kawananakoa
thomas_plantagenet_2nd_earl_of_lancaster	parents	blanche_of_artois
alexandra_pavlovna_of_russia	parents	paul_i_of_russia
sophia_of_hanover	children	sophia_charlotte_of_hanover
lili_damita	spouse	errol_flynn
henry_of_portugal	parents	manuel_i_of_portugal
maria_luisa_of_parma	children	infante_carlos_count_of_molina
mohammed_adil_shah	children	ali_adil_shah_ii
peter_i_of_brazil	spouse	amelie_de_beauharnais_of_leuchtenberg
elisabeth_of_france	gender	female
jacqueline_kennedy_onassis	profession	first_lady
theodosius_ii	profession	eastern_roman_emperor
marie_dagoult	profession	writer
sophia_dorothea_of_hanover	children	princess_friederike_luise_of_prussia
mary_of_teck	nationality	germany
penelope_blount_countess_of_devonshire	children	robert_rich_2nd_earl_of_warwick
cleopatra_selene	gender	female
ernest_augustus_iii_duke_of_brunswick	nationality	germany
herod_archelaus	parents	herod_the_great
frances_polidori	children	dante_gabriel_rossetti
sarah_lennox_duchess_of_richmond	children	lady_caroline_lennox
james_i_of_scotland	gender	male
anna_of_austria	gender	female
jane_wyman	profession	actor
louis_of_spain	place_of_death	madrid
miriam_a_ferguson	spouse	james_e_ferguson
anna_of_austria	nationality	austria
mary_de_bohun	nationality	kingdom_of_england
adelaide_of_lowenstein_wertheim_rosenberg	children	maria_josepha_of_portugal
carlos_thompson	gender	male
louise_elisabeth_of_orleans	parents	francoise_marie_de_bourbon
maria_jane_dyer	spouse	hudson_taylor
joan_hackett	gender	female
george_grossmith	nationality	england
john_burnside_1916	profession	inventor
princess_elizabeth_of_england	parents	henrietta_maria_of_france
guido_deiro	nationality	united_states
pearl_bailey	place_of_death	west_chester
maria_ii_of_portugal	gender	female
mehmed_vi	parents	abdulmecid
margaret_sullavan	spouse	william_wyler
amun-her-khepeshef	parents	nefertari
ferdinand_i_of_the_two_sicilies	religion	catholicism
john_f_kennedy_jr	institution	new_york_university
landgravine_elisabeth_amalie_of_hesse_darmstadt	place_of_death	neuburg_an_der_donau
hugh_de_stafford_2nd_earl_of_stafford	nationality	kingdom_of_england
adolf_friedrich_iii_duke_of_mecklenburg_strelitz	parents	adolf_frederick_ii_duke_of_mecklenburg_strelitz
lovisa_of_sweden	spouse	frederick_viii_of_denmark
frederick_edward_guest	parents	ivor_churchill_guest_1st_viscount_wimborne
edward_clinton_1st_earl_of_lincoln	nationality	england
john_campbell_9th_duke_of_argyll	place_of_death	cowes
david_carradine	profession	actor
isabella_of_jerusalem	gender	female
robert_ii_of_scotland	parents	marjorie_bruce
luz_magsaysay	spouse	ramon_magsaysay
joana_princess_of_beira	parents	luisa_of_medina-sidonia
michael_redgrave	nationality	united_kingdom
maria_amalia_of_saxony	cause_of_death	tuberculosis
alexis_i_of_russia	spouse	maria_miloslavskaya
james_mayer_de_rothschild	children	charlotte_de_rothschild
bess_meredyth	profession	screenwriter
thomas_edison	location	ohio
linda_gallegos	place_of_death	kenton_county
henry_cromwell	parents	elizabeth_bourchier
mabel_normand	nationality	united_states
carlos_hugo_of_bourbon_duke_of_parma	spouse	princess_irene_of_the_netherlands
osorkon_iii	children	takelot_iii
princess_alice_of_battenberg	place_of_death	buckingham_palace
henry_petty_fitzmaurice_3rd_marquess_of_lansdowne	nationality	united_kingdom
franz_frederick_anton_duke_of_saxe_coburg_saalfeld	place_of_death	coburg
caesarion	cause_of_death	strangling
grey_owl	cause_of_death	pneumonia
prince_augustus_frederick_duke_of_sussex	location	london
alfonso_iii_of_leon	children	fruela_ii_of_leon
ferdinand_i_of_romania	place_of_birth	sigmaringen
henry_ii_of_france	place_of_death	paris
adolf_frederick_of_sweden	place_of_death	stockholm_palace
archduke_wilhelm_franz_of_austria	parents	archduke_charles_duke_of_teschen
george_iii_of_the_united_kingdom	gender	male
archduke_charles_duke_of_teschen	children	archduke_frederick_ferdinand_of_austria
louis_xi_of_france	religion	catholicism
elizabeth_allan_1908	spouse	robert_montgomery
allison_defeo	gender	female
prince_vasili_alexandrovich_of_russia	parents	grand_duke_alexander_mikhailovich_of_russia
agnes_of_bohemia	gender	female
marvin_gaye	profession	composer
roger_needham	spouse	karen_sparck_jones
alexandre_vicomte_de_beauharnais	nationality	france
mihailo_obrenovic_iii_prince_of_serbia	cause_of_death	firearm
martin_boehm	nationality	united_states
tiberius	spouse	vipsania_agrippina
soong_ai-ling	parents	charlie_soong
thomas_quiney	spouse	judith_quiney
afonso_prince_imperial_of_brazil	cause_of_death	yellow_fever
archduke_otto_franz_of_austria	place_of_death	vienna
john_vi_of_portugal	religion	catholicism
chimalpopoca	gender	male
henry_iii_of_castile	spouse	catherine_of_lancaster
grand_duke_peter_nicolaievich_of_russia	children	princess_nadejda_petrovna_of_russia
maria_winteler_einstein	profession	physician
sophia_of_prussia	children	princess_katherine_of_greece_and_denmark
ogden_l_mills	parents	ogden_mills
james_roosevelt_sr	nationality	united_states
richard_mulligan	spouse	joan_hackett
sam_marx	nationality	united_states
michael_i_rangabe	children	patriarch_ignatios_of_constantinople
wilfrid_scawen_blunt	gender	male
jeanne_devreux	gender	female
inge_i_of_norway	parents	harald_iv_of_norway
blanche_of_artois	children	thomas_plantagenet_2nd_earl_of_lancaster
maria_miloslavskaya	children	ivan_v_of_russia
rose_fitzgerald_kennedy	children	joseph_p_kennedy_jr
charles_darwin	cause_of_death	coronary_thrombosis
belle_starr	gender	female
henry_v_count_palatine_of_the_rhine	nationality	germany
henry_iv_holy_roman_emperor	gender	male
gojong_of_korea	gender	male
frances_polidori	parents	gaetano_polidori
archduke_johann_of_austria	place_of_birth	florence
grand_duke_nicholas_nicolaevich_the_younger	place_of_death	french_riviera
chiang_kai-shek	children	chiang_wei-kuo
infanta_beatriz_of_spain	place_of_birth	segovia
peter_sellers	place_of_birth	portsmouth
charlotte_duchess_of_albany	gender	female
anna_of_bohemia_and_hungary	children	catherine_of_austria
valaya_alongkorn	parents	chulalongkorn
william_backhouse_astor_jr	institution	columbia_university
frank_reicher	profession	film_director
napoleon_iii_of_france	gender	male
grand_duchess_anastasia_nikolaevna_of_russia	profession	grand_duchess
benjamin_disraeli_1st_earl_of_beaconsfield	nationality	united_kingdom
clark_gable	cause_of_death	myocardial_infarction
jeanne_devreux	parents	margaret_of_artois
maria_fyodorovna	spouse	alexander_iii_of_russia
jesus	parents	blessed_virgin_mary
maximilian_i_of_bavaria	children	ludwig_i_of_bavaria
robert_montgomery	gender	male
infanta_isabella_clara_eugenia_of_spain	gender	female
olof_of_sweden	children	iziaslav_i_of_kiev
charlotte_of_savoy	spouse	louis_xi_of_france
victoria_of_the_united_kingdom	children	edward_vii_of_the_united_kingdom
mae_west	profession	playwright
alice_betty_stern	ethnicity	jew
ramon_berenguer_i_count_of_barcelona	gender	male
frederick_ii_of_prussia	location	berlin
albert_of_saxe-coburg_and_gotha	children	prince_arthur_duke_of_connaught_and_strathearn
almodis_de_la_marche	gender	female
francis_i_of_france	children	francois_dauphin_of_france
princess_alexandra_of_edinburgh_and_saxe-coburg-gotha	gender	female
william_shakespeare	religion	church_of_england
jennie_churchill	nationality	united_states
shuja-ud-daula	gender	male
charles_lennox_2nd_duke_of_richmond	children	lady_sarah_lennox
frances_stevenson	spouse	david_lloyd_george
william_henry_vanderbilt	place_of_death	new_york
thomas_rolfe	gender	male
john_vi_of_portugal	children	peter_i_of_brazil
infante_carlos_count_of_molina	gender	male
ulrich_ii_count_of_ostfriesland	children	enno_louis_prince_of_ostfriesland
marjorie_merriweather_post	gender	female
ronald_reagan	spouse	jane_wyman
nathan_mayer_rothschild	place_of_birth	frankfurt
maria_luisa_of_savoy	nationality	italy
chulalongkorn	children	sirabhorn_sobhon
anna_of_holstein-gottorp	children	rudolf_christian_count_of_ostfriesland
bernhard_ii_erich_freund_duke_of_saxe_meiningen	children	georg_ii_duke_of_saxe_meiningen
infante_fernando_duke_of_viseu	nationality	portugal
charles_v_holy_roman_emperor	nationality	spain
peter_i_of_brazil	parents	john_vi_of_portugal
princess_leopoldina_of_brazil	parents	teresa_of_the_two_sicilies
grand_duchess_elizabeth_mikhailovna	place_of_death	wiesbaden
johann_bernoulli	gender	male
abaqa_khan	children	arghun
carole_lombard	place_of_death	las_vegas_metropolitan_area
fletcher_christian	children	thursday_october_christian
maximilian_sforza	parents	beatrice_deste
eleanor_of_castile	gender	female
anne_of_york	spouse	thomas_howard_3rd_duke_of_norfolk
empress_matilda	place_of_birth	winchester
afonso_vi_of_portugal	nationality	portugal
radegund	spouse	clotaire_i
mehmed_ii	place_of_birth	edirne
ray_bridwell_white	place_of_birth	denver
gaius_octavius	children	augustus
mary_boleyn	children	catherine_carey
adam_jerzy_czartoryski	profession	politician
arthur_i_duke_of_brittany	parents	constance_duchess_of_brittany
john_of_gaunt_1st_duke_of_lancaster	gender	male
christopher_columbus	nationality	italy
geraldine_apponyi_de_nagy-apponyi	spouse	zog_of_albania
fulk_of_jerusalem	children	amalric_i_of_jerusalem
alexander_jagiellon	gender	male
joan_crawford	nationality	france
otto_frank	gender	male
mary_stuart_countess_of_bute	spouse	john_stuart_3rd_earl_of_bute
faisal_ii_of_iraq	profession	politician
sofia_albertina_princess_of_sweden	parents	louisa_ulrika_of_prussia
louis_xvi_of_france	gender	male
maximilian_ii_holy_roman_emperor	place_of_birth	vienna
alexandra_pavlovna_of_russia	parents	maria_fyodorovna_of_russia
albert_v_duke_of_bavaria	place_of_death	munich
francis_i_holy_roman_emperor	children	joseph_ii_holy_roman_emperor
eleanor_of_spain	parents	philip_i_of_castile
eric_xiv_of_sweden	parents	gustav_i_of_sweden
leka_crown_prince_of_albania	gender	male
george_of_saxony	children	princess_maria_josepha_of_saxony
abigail_kapiolani_kawananakoa	parents	david_kawananakoa
catherine_de_medici	place_of_birth	florence
virginia_heinlein	profession	biochemist
isabella_of_angouleme	children	alice_le_brun_de_lusignan
frederica_of_mecklenburg-strelitz	gender	female
edward_blake	religion	anglicanism
john_albert_vasa	parents	sigismund_iii_vasa
michael_curtiz	profession	film_director
ferdinand_i_of_romania	children	elisabeth_of_romania
pearl_bailey	spouse	louie_bellson
isabella_of_jerusalem	children	maria_of_montferrat
darius_ogden_mills	place_of_birth	north_salem
isabel_princess_imperial_of_brazil	parents	pedro_ii_of_brazil
princess_louise_charlotte_of_denmark	children	louise_of_hesse-kassel
artabastos	gender	male
robert_e_lee	children	william_henry_fitzhugh_lee
frederick_howard_taylor	nationality	united_kingdom
larisa_shepitko	spouse	elem_klimov
louis_ferdinand_prince_of_prussia	gender	male
mary_curzon_baroness_curzon_of_kedleston	gender	female
robert_ii_of_scotland	spouse	elizabeth_mure
maria_alexandrovna_of_russia	place_of_birth	tsarskoye_selo
kishore_kumar	religion	hinduism
prince_arthur_duke_of_connaught_and_strathearn	spouse	princess_louise_margaret_duchess_of_connaught
christian_bohr	children	harald_bohr
george_c_scott	institution	university_of_missouri_columbia
fred_perry	nationality	united_kingdom
joan_of_england_queen_of_sicily	nationality	kingdom_of_england
alice_of_the_united_kingdom	profession	grand_duchess
sophia_of_hanover	gender	female
henry_vii_of_england	profession	monarch
tiberius_nero	children	tiberius
nero_claudius_drusus	nationality	roman_empire
postumus	cause_of_death	assassination
adolf_friedrich_iii_duke_of_mecklenburg_strelitz	place_of_death	schwerin
henry_howard_6th_duke_of_norfolk	nationality	england
lachlan_macquarie	gender	male
eleanor_of_castile	nationality	england
frances_stevenson	location	london
elizabeth_clinton_countess_of_lincoln	spouse	edward_clinton_1st_earl_of_lincoln
walter_rothschild_2nd_baron_rothschild	parents	nathan_rothschild_1st_baron_rothschild
anne_marie_martinozzi	children	louis_armand_i_prince_of_conti
john_d_rockefeller_jr	cause_of_death	pneumonia
alexander_prince_of_bulgaria	gender	male
claudius	place_of_birth	lyon
tancred_ibsen	profession	screenwriter
ferdinand_maria_elector_of_bavaria	children	joseph_clemens_of_bavaria
ludwig_i_of_bavaria	gender	male
joan_de_geneville_baroness_geneville	place_of_birth	ludlow_castle
anne_of_austria	gender	female
philipp_wilhelm_elector_palatine	children	dorothea_sophie_of_neuburg
athelstan_of_england	place_of_death	gloucester
georg_grand_duke_of_mecklenburg_strelitz	parents	friederike_of_hesse_darmstadt
frederick_iii_german_emperor	place_of_death	potsdam
charles_xiv_john_of_sweden	profession	generalissimo
ann_dunham	parents	stanley_armour_dunham
tey	gender	female
maria_theresa_of_austria_and_tuscany	spouse	charles_albert_of_sardinia
willem_van_keppel_2nd_earl_of_albemarle	nationality	england
marguerite_of_france_1158	nationality	france
james_otis_sr	children	james_otis
ada_lovelace	children	lady_anne_blunt
luis_munoz_marin	profession	politician
marie_de_champagne	gender	female
henri_dorleans_duc_daumale	place_of_birth	paris
helen_vinson	place_of_birth	beaumont
otto_frank	ethnicity	germans
catharina_of_sweden	parents	charles_ix_of_sweden
francis_hyacinth_duke_of_savoy	parents	victor_amadeus_i_duke_of_savoy
leopold_iii_of_belgium	children	baudouin_of_belgium
adam_ludwik_czartoryski	parents	wladyslaw_czartoryski
henry_iii_holy_roman_emperor	parents	gisela_of_swabia
grand_duchess_vera_konstantinovna_of_russia	gender	female
ogden_l_mills	institution	harvard_law_school
alexander_ii_of_russia	profession	emperor
thomas_bourchier	nationality	kingdom_of_england
tsarevich_alexei_nikolaevich_of_russia	nationality	russia
alfonso_carlos_duke_of_san_jaime	place_of_death	vienna
george_darwin	gender	male
gisela_of_swabia	gender	female
victoria_princess_royal	place_of_birth	buckingham_palace
pretty_shield	spouse	goes_ahead
alfonso_iv_deste	place_of_birth	modena
bezmialem	children	abdulmecid
joseph_ii_holy_roman_emperor	place_of_birth	vienna
evelyn_keyes	spouse	artie_shaw
penelope_blount_countess_of_devonshire	parents	walter_devereux_1st_earl_of_essex
edmund_tudor_1st_earl_of_richmond	spouse	margaret_beaufort
henry_herbert_2nd_earl_of_pembroke	children	philip_herbert_4th_earl_of_pembroke
winston_churchill	cause_of_death	stroke
nissanka_wijeyeratne	religion	buddhism
catherine_of_aragon	religion	roman_catholic_church
kekauluohi_likelike	spouse	archibald_cleghorn
venetia_stanley_1887	nationality	united_kingdom
adolf_frederick_of_sweden	gender	male
franz_liszt	children	cosima_wagner
gerberga_of_saxony	parents	henry_i_of_germany
charlotte_of_spain	children	miguel_of_portugal
charles_ix_of_sweden	gender	male
leonora_of_england	children	urraca_princess_of_castile
alexander_ii_of_russia	cause_of_death	regicide
ptolemy_iv_philopator	gender	male
niels_bohr	profession	physicist
ordono_ii_of_leon	gender	male
sarah	religion	judaism
adelaide_of_lowenstein_wertheim_rosenberg	children	miguel_ii_duke_of_braganza
anna_jagiellon	place_of_death	warsaw
augustus_de_morgan	gender	male
harilal_gandhi	gender	male
infante_joao_of_portugal	parents	philippa_of_lancaster
piam	gender	male
eulalia_duchess_of_galliera	gender	female
william_backhouse_astor_jr	children	john_jacob_astor_iv
francesco_i_deste	children	alfonso_iv_deste
mountjoy_blount_1st_earl_of_newport	parents	penelope_blount_countess_of_devonshire
philip_iii_of_france	gender	male
elena_of_montenegro	parents	nicholas_i_of_montenegro
grand_duchess_vera_konstantinovna_of_russia	parents	grand_duke_konstantin_nikolayevich_of_russia
oliver_cromwell	nationality	england
j_p_morgan_jr	cause_of_death	stroke
baidar	parents	chagatai_khan
harald_iv_of_norway	parents	magnus_iii_of_norway
robert_mackay	gender	male
henry_petty_fitzmaurice_3rd_marquess_of_lansdowne	parents	william_petty_2nd_earl_of_shelburne
david_alfred_thomas	nationality	united_kingdom
john_barrymore	place_of_death	los_angeles
chokkanatha_nayak	religion	hinduism
william_shakespeare	profession	poet
prince_georg_of_bavaria	nationality	germany
elizabeth_cady_stanton	spouse	henry_stanton
peter_van_pels	parents	hermann_van_pels
judith_quiney	parents	william_shakespeare
blanche_i_of_navarre	spouse	martin_i_of_sicily
pierre_curie	children	irene_joliot-curie
leatrice_joy	location	greenwich_connecticut
august_anheuser_busch_sr	gender	male
barbara_of_portugal	spouse	ferdinand_vi_of_spain
friederike_of_hesse_darmstadt	children	frederica_of_mecklenburg-strelitz
theodosius_i	gender	male
livilla	spouse	julius_caesar_drusus
hermann_einstein	spouse	pauline_koch
mongkut	religion	buddhism
vratislaus_ii_of_bohemia	children	bretislaus_ii_of_bohemia
louis_of_etruria	gender	male
empress_xiaoquan_cheng	spouse	daoguang_emperor
mary_boleyn	nationality	kingdom_of_england
enno_iii_count_of_ostfriesland	place_of_birth	aurich
henri_victor_regnault	children	henri_regnault
princess_louise_of_prussia	parents	william_i_german_emperor
gian_gastone_de_medici_grand_duke_of_tuscany	place_of_birth	florence
john_f_fitzgerald	children	rose_fitzgerald_kennedy
kikkawa_motoharu	parents	mori_motonari
henry_i_of_england	parents	matilda_of_flanders
charles_lennox_3rd_duke_of_richmond	nationality	united_kingdom
sigismund_i_the_old	spouse	bona_sforza
errol_flynn	profession	actor
erwig	gender	male
boleslaw_ii_of_poland	parents	casimir_i_of_poland
arthur_i_duke_of_brittany	gender	male
ferdinand_i_holy_roman_emperor	place_of_birth	alcala_de_henares
philibert_i_duke_of_savoy	parents	amadeus_ix_duke_of_savoy
charles_darwin	religion	agnosticism
caesonia	cause_of_death	assassination
zeb-un-nissa	parents	aurangzeb
artabastos	parents	erwig
georg_donatus_hereditary_grand_duke_of_hesse	spouse	princess_cecilie_of_greece_and_denmark
beatrice_ephrussi_de_rothschild	parents	alphonse_james_de_rothschild
princess_tia	parents	seti_i
marvin_pentz_gay_sr	cause_of_death	pneumonia
louis_devreux	nationality	france
grand_duchess_catherine_mikhailovna_of_russia	parents	elena_pavlovna_of_wurttemberg
louise_mountbatten	parents	princess_victoria_of_hesse_and_by_rhine
caligula	cause_of_death	tyrannicide
ivy_cavendish_bentinck_duchess_of_portland	spouse	william_cavendish_bentinck_7th_duke_of_portland
claudius	parents	nero_claudius_drusus
beatriz_of_portugal	religion	roman_catholic_church
virginia_heinlein	spouse	robert_a_heinlein
robert_montgomery	place_of_death	new_york
darius_ogden_mills	gender	male
princess_leopoldina_of_brazil	place_of_birth	rio_de_janeiro
wilfrid_scawen_blunt	profession	author
marc_defeo	location	new_york_state
francois_de_bourbon_prince_de_conti	place_of_birth	la_ferte_sous_jouarre
john_elector_of_saxony	parents	ernest_elector_of_saxony
miguel_of_portugal	religion	catholicism
john_f_kennedy_jr	parents	john_f_kennedy
maria_louisa_of_spain	parents	charles_iii_of_spain
archduchess_luise_princess_of_tuscany	nationality	austria
louis_vii_of_france	parents	louis_vi_of_france
lady_elizabeth_stanley	parents	ferdinando_stanley_5th_earl_of_derby
john_b_kelly_sr	children	grace_kelly
henry_v_of_england	profession	monarch
archduke_anton_victor_of_austria	location	florence
albert_iv_duke_of_bavaria	spouse	kunigunde_of_austria
major_ridge	children	john_ridge
winston_churchill	profession	member_of_parliament
eleanor_anne_porden	cause_of_death	tuberculosis
magnus_i_of_norway	gender	male
octavia_minor	spouse	mark_antony
edward_r_murrow	ethnicity	irish_people
jesus	profession	carpenter
frederick_wilhelm_duke_of_saxe_meiningen	parents	bernhard_i_duke_of_saxe_meiningen
alexander_i_of_greece	place_of_birth	athens
maria_josepha_of_portugal	nationality	portugal
andronikos_iii_palaiologos	gender	male
felipe_prospero_of_habsburg	parents	philip_iv_of_spain
chico_marx	cause_of_death	cardiovascular_disease
desiree_clary	spouse	charles_xiv_john_of_sweden
francis_ii_holy_roman_emperor	gender	male
michael_curtiz	spouse	bess_meredyth
william_henry_vanderbilt	place_of_birth	new_brunswick_new_jersey
ahaz	children	hezekiah
frederika_of_hanover	nationality	germany
maria_theresa_of_austria	spouse	francis_i_holy_roman_emperor
charles_lennox_2nd_duke_of_richmond	nationality	england
henry_the_lion	children	otto_iv_holy_roman_emperor
kunigunde_of_austria	gender	female
maria_amalia_of_the_two_sicilies	gender	female
franchot_tone	profession	actor
william_cavendish_bentinck_7th_duke_of_portland	children	lady_anne_cavendish_bentinck
pauline_koch	religion	jew
ida_lupino	spouse	howard_duff
julie_london	spouse	bobby_troup
winston_churchill	profession	author
stephen_i_of_hungary	religion	roman_catholic_church
maria_winteler_einstein	location	italy
james_cruze	spouse	betty_compson
eleanor_stewart_princess_of_scotland	gender	female
diana_barrymore	gender	female
benjamin_thompson	religion	anglicanism
shabaka	parents	kashta
justinus_van_nassau	parents	william_the_silent
princess_victoria_of_hesse_and_by_rhine	children	princess_alice_of_battenberg
ann_dunham	ethnicity	white_american
taksony_of_hungary	gender	male
constance_of_aragon	gender	female
ferdinand_i_of_aragon	religion	catholicism
effie_gray	gender	female
catherine_of_lancaster	place_of_death	valladolid
thomas_plantagenet_2nd_earl_of_lancaster	nationality	kingdom_of_england
john_f_kennedy_jr	gender	male
adelaide_of_aquitaine	gender	female
hugh_percy_1st_duke_of_northumberland	children	james_smithson
nathan_rothschild_1st_baron_rothschild	children	walter_rothschild_2nd_baron_rothschild
piroska_of_hungary	place_of_birth	esztergom
henry_of_scotland_3rd_earl_of_huntingdon	children	william_i_of_scotland
constantius_ii	parents	constantine_i
infante_fernando_duke_of_viseu	spouse	beatriz_of_portugal
ernest_elector_of_saxony	children	christina_of_saxony
radegund	gender	female
olga_feodorovna_grand_duchess_of_russia	children	grand_duchess_anastasia_mikhailovna_of_russia
sunandha	parents	piam
rembrandt	place_of_death	amsterdam
sten_sture_the_younger	gender	male
francesco_i_deste	nationality	italy
yixuan_1st_prince_chun	ethnicity	manchu
james_a_bayard	institution	princeton_university
reccesuinth	parents	chindasuinth
edmund_of_langley_1st_duke_of_york	nationality	kingdom_of_england
harry_davenport	cause_of_death	myocardial_infarction
claude_of_france	children	margaret_of_france_duchess_of_berry
princess_sophia_dorothea_of_prussia	nationality	germany
doris_blackburn	place_of_birth	melbourne_australia
william_petty_2nd_earl_of_shelburne	gender	male
eleonore_of_solms_hohensolms_lich	spouse	ernest_louis_grand_duke_of_hesse
henri_victor_regnault	place_of_birth	aachen
adolphus_busch_iii	nationality	united_states
archduchess_elisabeth_franziska_of_austria	religion	roman_catholic_church
marie_louise_duchess_of_parma	religion	catholicism
john_f_kennedy	place_of_birth	brookline
charles_de_bourbon_charolais	gender	male
georg_ii_duke_of_saxe_meiningen	children	frederick_johann_of_saxe-meiningen
wallace_reid	spouse	dorothy_davenport
alia_al_hussein	spouse	hussein_of_jordan
brian_kelly_hell	institution	university_of_michigan
ananda_mahidol	cause_of_death	firearm
ramon_magsaysay	religion	catholicism
ferdinand_vii_of_spain	parents	maria_luisa_of_parma
evelyn_de_morgan	profession	artist
fruela_ii_of_leon	parents	alfonso_iii_of_leon
sophia_magdalen_of_brandenburg-kulmbach	gender	female
moctezuma_ii	gender	male
jiaqing_emperor	gender	male
dorothea_of_brandenburg	gender	female
david_alfred_thomas	nationality	wales
catherine_carey	gender	female
henry_stanton	nationality	united_states
jenny_likens	gender	male
archduke_franz_ferdinand_of_austria	parents	maria_annunciata_of_the_two_sicilies
louis_antoine_duke_of_angouleme	place_of_birth	palace_of_versailles
louis_dauphin_de_france	place_of_death	chateau_de_fontainebleau
infanta_maria_teresa_of_spain	gender	female
louis_duke_of_savoy	children	jacques_duke_of_savoy
claire_olivia_newman	parents	paul_newman
mark_antony	nationality	roman_republic
christian_ii_elector_of_saxony	place_of_death	dresden
alice_spencer	gender	female
amalric_i_of_jerusalem	children	isabella_of_jerusalem
archduke_joseph_of_austria_palatine_of_hungary	gender	male
archduchess_maria_josepha_of_austria	place_of_birth	hofburg_imperial_palace
archduchess_maria_josepha_of_austria	place_of_death	vienna
julia_ward_howe	gender	male
otto_i_holy_roman_emperor	children	otto_ii_holy_roman_emperor
maria_amalia_of_the_two_sicilies	children	antoine_duke_of_montpensier
eva_macmurrough	children	isabel_de_clare_4th_countess_of_pembroke
barbara_of_portugal	place_of_death	madrid
henri_regnault	parents	henri_victor_regnault
tsarevich_alexei_nikolaevich_of_russia	parents	nicholas_ii_of_russia
sylvia_brett	spouse	charles_vyner_brooke
duke_peter_of_oldenburg	children	grand_duchess_alexandra_petrovna
christina_of_sweden	parents	maria_eleonora_of_brandenburg
ogden_l_mills	gender	male
scribonia	children	julia_the_elder
mae_west	spouse	guido_deiro
sigismund_i_the_old	gender	male
tyrone_power	parents	tyrone_power_sr
arthur_de_wint_foote	spouse	mary_hallock_foote
vespasian	spouse	domitilla_the_elder
chlodomer	children	clodoald
otto_iii_holy_roman_emperor	gender	male
miguel_of_portugal	children	miguel_ii_duke_of_braganza
lady_frances_brandon	children	lady_jane_grey
grand_duke_peter_nicolaievich_of_russia	spouse	anastasia_of_montenegro
alfonso_vii_of_leon	religion	catholicism
josephine_of_leuchtenberg	location	milan_italy
alfonso_iv_of_leon	religion	catholicism
martin_boehm	profession	clergy
fulk_iv_of_anjou	spouse	bertrade_de_montfort
henry_ii_of_france	children	claude_of_valois
andronikos_iii_palaiologos	spouse	anna_of_savoy
ferdinand_i_of_aragon	gender	male
kenneth_thomson_2nd_baron_thomson_of_fleet	nationality	canada
princess_louise_of_prussia	children	victoria_of_baden
albert_iv_duke_of_bavaria	gender	male
ivan_v_of_russia	profession	monarch
alexander_of_islay_earl_of_ross	parents	domhnall_of_islay_lord_of_the_isles
george_v_of_the_united_kingdom	nationality	united_kingdom
saskia_van_uylenburg	cause_of_death	tuberculosis
ernest_hemingway	nationality	united_states
george_grossmith	profession	singer
talitha_getty	cause_of_death	heroin_overdose
edward_iv_of_england	children	mary_of_york
basil_ii	gender	male
mary_i_of_scotland	gender	female
johann_wilhelm_elector_palatine	spouse	anna_maria_luisa_de_medici
bess_meredyth	gender	female
geza_of_hungary	children	judith_of_hungary
afonso_v_of_portugal	spouse	joan_princess_of_castile
gustav_iii_of_sweden	cause_of_death	assassination
jenny_von_westphalen	children	laura_marx
louis_the_stammerer	parents	charles_the_bald
robert_e_lee	cause_of_death	pneumonia
caesarion	parents	julius_caesar
princess_helene_of_orleans	children	amedeo_3rd_duke_of_aosta
henry_i_duke_of_guise	parents	anna_deste
nefertari	gender	female
sven_o_hoiby	profession	journalist
elisabeth_of_austria	children	sigismund_i_the_old
louise_of_hesse-kassel	children	alexandra_of_denmark
franz_xaver_wolfgang_mozart	gender	male
eva_marshal	gender	female
francis_duke_of_teck	nationality	united_kingdom
henry_viii_of_england	religion	church_of_england
augustus	parents	atia
philipp_wilhelm_elector_palatine	children	maria_anna_of_pfalz-neuburg
consuelo_vanderbilt	place_of_birth	new_york
albert_vii_archduke_of_austria	gender	male
john_i_of_castile	children	henry_iii_of_castile
berenguela_of_castile	parents	leonora_of_england
john_f_fitzgerald	location	boston_massachusetts
george_mackinnon_wrong	nationality	canada
lilli_palmer	ethnicity	germans
princess_adelgunde_of_bavaria	place_of_death	munich
charlotte_of_spain	gender	female
josephine_of_leuchtenberg	children	charles_xv_of_sweden
victoria_eugenia_of_battenberg	nationality	scotland
princess_alexandra_of_edinburgh_and_saxe-coburg-gotha	parents	maria_alexandrovna_of_russia
david_ii_of_scotland	parents	robert_i_of_scotland
paul_newman	children	claire_olivia_newman
alma_bridwell_white	location	kentucky
joseph_ii_holy_roman_emperor	place_of_death	vienna
henry_x_duke_of_bavaria	spouse	gertrud_of_supplingenburg
marjorie_bruce	parents	isabella_of_mar
john_iii_duke_of_cleves	children	sybille_of_cleves
qianlong_emperor	children	jiaqing_emperor
adele_of_champagne	spouse	louis_vii_of_france
sophia_alekseyevna	gender	female
jacqueline_kennedy_onassis	cause_of_death	cancer
richard_i_of_england	gender	male
charles_ferdinand_duc_de_berry	gender	male
john_hays_hammond_jr	profession	inventor
kasturba_gandhi	spouse	mahatma_gandhi
otto_i_duke_of_saxony	children	henry_i_of_germany
ranuccio_i_farnese_duke_of_parma	parents	infanta_maria_of_guimaraes
sylvia_plath	institution	smith_college
simone_signoret	place_of_birth	wiesbaden
lord_randolph_churchill	nationality	england
jeanne_ii_countess_of_burgundy	spouse	philip_v_of_france
william_i_of_england	gender	male
marie_de_champagne	parents	eleanor_of_aquitaine
maurice_blackburn	profession	lawyer
robert_ii_of_france	spouse	constance_of_arles
gerberga_of_saxony	gender	female
infanta_beatriz_of_spain	parents	victoria_eugenia_of_battenberg
mark_antony	location	rome
alfonso_iv_deste	nationality	italy
princess_margaret_of_prussia	parents	frederick_iii_german_emperor
charles_xiv_john_of_sweden	nationality	kingdom_of_france
joseph_e_davies	spouse	marjorie_merriweather_post
louisa_ulrika_of_prussia	spouse	adolf_frederick_of_sweden
hudson_taylor	profession	physician
ptolemy_iii_euergetes	children	arsinoe_iii_of_egypt
thomas_jefferson	children	martha_jefferson_randolph
gojong_of_korea	spouse	empress_myeongseong
frederick_ii_duke_of_saxe_gotha_altenburg	parents	frederick_i_duke_of_saxe_gotha_altenburg
feodor_i_of_russia	gender	male
augustus_keppel_1st_viscount_keppel	parents	willem_van_keppel_2nd_earl_of_albemarle
nero_claudius_drusus	gender	male
claire_olivia_newman	parents	joanne_woodward
stephen_i_of_hungary	ethnicity	hungarian_people
sophia_of_prussia	children	alexander_i_of_greece
charles_ferdinand_duc_de_berry	parents	charles_x_of_france
amenhotep_ii	gender	male
prince_ernst_von_hohenberg	place_of_death	graz
anna_deste	children	charles_of_lorraine_duke_of_mayenne
lionel_de_rothschild	profession	politician
mary_stuart_countess_of_bute	profession	first_lady
canute_the_great	place_of_birth	denmark
charles_ferdinand_duc_de_berry	parents	marie_therese_of_savoy
artie_shaw	cause_of_death	diabetes_mellitus
james_ii_of_scotland	place_of_birth	holyrood_palace
victoria_eugenia_of_battenberg	place_of_death	lausanne
nelle_wilson_reagan	children	ronald_reagan
albert_kamehameha	place_of_birth	honolulu
tolui_borjigin	parents	borte
frederick_iv_elector_palatine	parents	louis_vi_elector_palatine
edward_the_elder	gender	male
peter_sellers	spouse	lynne_frederick
julia_the_elder	spouse	marcus_vipsanius_agrippa
napoleon_louis_bonaparte	gender	male
george_of_saxony	religion	roman_catholic_church
haakon_vii_of_norway	profession	monarch
herbert_marshall	nationality	england
roy_thomson_1st_baron_thomson_of_fleet	gender	male
john_f_kennedy	institution	london_school_of_economics
leo_i	profession	eastern_roman_emperor
eugene_de_beauharnais	location	paris
frederick_iii_elector_of_saxony	gender	male
luis_munoz_marin	spouse	ines_mendoza
eva_braun	cause_of_death	cyanide_poisoning
philippa_of_lancaster	gender	female
prince_louis_ferdinand_of_bavaria	parents	infanta_amelia_philippina_of_spain
frederick_william_iii_of_prussia	spouse	louise_of_mecklenburg-strelitz
victor_emmanuel_iii_of_italy	religion	catholicism
frances_stevenson	institution	royal_holloway_university_of_london
maria_louisa_of_spain	parents	maria_amalia_of_saxony
louise_henriette_de_bourbon_conti	parents	louis_armand_ii_de_bourbon_prince_de_conti
alexander_ii_of_russia	cause_of_death	assassination
eleanor_roosevelt	cause_of_death	tuberculosis
pearl_starr	parents	belle_starr
edith_of_scotland	spouse	henry_i_of_england
christina_rossetti	parents	frances_polidori
john_iii_duke_of_cleves	gender	male
thomas_jefferson	profession	inventor
tiberius	children	julius_caesar_drusus
william_iv_of_the_united_kingdom	cause_of_death	myocardial_infarction
john_manners_2nd_duke_of_rutland	gender	male
pier_luigi_farnese_duke_of_parma	place_of_death	piacenza
eugene_de_beauharnais	parents	josephine_de_beauharnais
jacques_duke_of_savoy	gender	male
prince_frederick_of_hesse	nationality	germany
ferdinand_duke_of_genoa	parents	maria_theresa_of_austria_and_tuscany
countess_palatine_caroline_of_zweibrucken	gender	female
carole_lombard	spouse	clark_gable
philip_iv_of_france	cause_of_death	animal_attack
prince_johann_georg_of_saxony	religion	roman_catholic_church
anna_e_roosevelt	institution	cornell_university
archibald_cleghorn	place_of_birth	scotland
bahadur_shah_i	gender	male
joan_crawford	spouse	phillip_terry
franz_frederick_anton_duke_of_saxe_coburg_saalfeld	gender	male
alfonso_iii_of_leon	gender	male
bettye_ackerman	cause_of_death	stroke
prince_francis_joseph_of_braganza	place_of_birth	meran-merano
eva_macmurrough	gender	female
john_carradine	nationality	united_states
christina_rossetti	nationality	england
francis_i_of_france	children	henry_ii_of_france
otto_iv_holy_roman_emperor	religion	catholicism
joan_de_geneville_baroness_geneville	gender	female
carol_ii_of_romania	place_of_death	estoril
liudolf_duke_of_saxony	gender	male
kaiulani	parents	kekauluohi_likelike
arghun	gender	male
charles_lennox_1st_duke_of_richmond	children	charles_lennox_2nd_duke_of_richmond
blanche_of_artois	place_of_death	paris
constance_of_aragon	nationality	germany
prajadhipok	gender	male
herbert_marshall	spouse	boots_mallory
amelia_of_wurttemberg	children	alexandra_iosifovna_of_altenburg
afonso_1st_duke_of_braganza	gender	male
victor_emmanuel_iii_of_italy	place_of_death	alexandria
guangxu_emperor	gender	male
karen_sparck_jones	gender	female
william_h_seward	children	frederick_w_seward
diego_colon	nationality	spain
mary_de_bohun	nationality	england
thutmose_iv	parents	amenhotep_ii
marie_of_edinburgh	profession	nurse
sophia_of_hanover	parents	frederick_v_elector_palatine
frederick_v_elector_palatine	parents	louise_juliana_of_nassau
archduke_maximilian_franz_of_austria	gender	male
infanta_amelia_philippina_of_spain	gender	female
charles_xv_of_sweden	children	lovisa_of_sweden
false_dmitriy_i	parents	stefan_batory
john_ii_of_aragon	spouse	blanche_i_of_navarre
cleopatra_vii_of_egypt	spouse	ptolemy_xiii_theos_philopator
alva_belmont	spouse	william_kissam_vanderbilt
irene_joliot-curie	gender	female
stefan_batory	gender	male
alfonso_xiii_of_spain	gender	male
prince_ludwig_of_hesse_and_by_rhine	cause_of_death	airplane_crash
pesach_burstein	nationality	israel
peter_i_of_brazil	ethnicity	white_latin_american
catherine_of_aragon	gender	female
h_p_lovecraft	religion	atheism
tancred_ibsen	profession	film_director
marvin_gaye	profession	record_producer
huey_long	institution	tulane_university
wladyslaw_ii_the_exile	gender	male
edmund_of_langley_1st_duke_of_york	parents	philippa_of_hainault
princess_amelia_of_the_united_kingdom	parents	charlotte_of_mecklenburg-strelitz
grand_duchess_alexandra_petrovna	children	grand_duke_peter_nicolaievich_of_russia
alfonso_vii_of_leon	children	sancho_iii_of_castile
pedro_ii_of_brazil	children	afonso_prince_imperial_of_brazil
christian_ix_of_denmark	nationality	denmark
charles_lennox_3rd_duke_of_richmond	gender	male
prince_leopold_of_bavaria	spouse	archduchess_gisela_of_austria
clementine_churchill_baroness_spencer_churchill	profession	first_lady
charles_lennox_2nd_duke_of_richmond	parents	charles_lennox_1st_duke_of_richmond
grand_duchess_maria_nikolaevna_of_russia	cause_of_death	murder
louis_of_bourbon_duke_of_orleans	gender	male
john_d_spreckels	parents	claus_spreckels
prince_valdemar_of_denmark	spouse	marie_of_orleans
mehmed_i	children	murad_ii
princess_amelia_sophia_of_great_britain	parents	george_ii_of_great_britain
phillip_terry	nationality	united_states
tiberius_nero	gender	male
catherine_of_austria	place_of_birth	innsbruck
prajadhipok	parents	saovabha
mary_of_teck	children	mary_princess_royal_and_countess_of_harewood
anna_of_habsburg	gender	female
joan_beaufort_queen_of_scotland	nationality	scotland
constantine_vii	profession	writer
george_formby	profession	singer-songwriter
ines_mendoza	spouse	luis_munoz_marin
infante_augusto_duke_of_coimbra	parents	ferdinand_ii_of_portugal
gilbert_gallegos	nationality	united_states
henry_iii_of_england	gender	male
atia	children	early_life_of_augustus
gilbert_talbot_7th_earl_of_shrewsbury	gender	male
charles_brandon_1st_duke_of_suffolk	gender	male
juliana_maria_of_brunswick_wolfenbuttel	gender	female
ferdinand_iii_of_castile	nationality	spain
eleanor_de_roucy_de_roye	spouse	louis_i_de_bourbon_prince_de_conde
frederick_v_elector_palatine	children	prince_rupert_of_the_rhine
philip_i_of_taranto	parents	charles_ii_of_naples
caligula	parents	germanicus
constantine_viii	gender	male
ernest_elector_of_saxony	place_of_birth	meissen
moctezuma_ii	children	chimalpopoca
maria_of_brabant	place_of_birth	leuven
jodhabai	children	jahangir
princess_sophia_dorothea_of_prussia	parents	frederick_william_i_of_prussia
georg_ii_duke_of_saxe_meiningen	place_of_death	bad_wildungen
grand_duke_george_mikhailovich_of_russia	gender	male
louis_x_of_france	place_of_birth	paris
aelia_paetina	gender	female
eleanor_of_aquitaine	children	geoffrey_ii_duke_of_brittany
ptolemy_iii_euergetes	children	ptolemy_iv_philopator
john_albert_vasa	cause_of_death	smallpox
martin_boehm	children	henry_boehm
augustus_ii_the_strong	religion	catholicism
miklos_horthy	nationality	hungary
john_d_rockefeller_jr	nationality	united_states
jiaqing_emperor	spouse	empress_xiaoshu_rui
alexandra_fyodorovna	children	grand_duke_konstantin_nikolayevich_of_russia
robert_rich_2nd_earl_of_warwick	place_of_death	london
mary_tudor	spouse	charles_brandon_1st_duke_of_suffolk
edward_r_murrow	cause_of_death	cancer
julia_ward_howe	gender	female
alexander_iii_of_russia	place_of_birth	saint_petersburg
prince_alfons_of_bavaria	children	prince_joseph_clemens_of_bavaria
christian_ii_elector_of_saxony	gender	male
karen_sparck_jones	profession	computer_scientist
charles_xiv_john_of_sweden	profession	marshal
marvin_pentz_gay_sr	children	marvin_gaye
nadejda_mountbatten_marchioness_of_milford_haven	nationality	united_kingdom
grand_duke_michael_mihailovich_of_russia	children	nadejda_mountbatten_marchioness_of_milford_haven
maria_teresa_of_the_two_sicilies	children	ferdinand_i_of_austria
lady_sarah_lennox	parents	charles_lennox_2nd_duke_of_richmond
ludwig_ii_of_bavaria	parents	maximilian_ii_of_bavaria
archduke_carl_ludwig_of_austria	children	archduke_franz_ferdinand_of_austria
joseph_p_kennedy_sr	gender	male
henrietta_maria_of_france	gender	female
louis_viii_of_france	place_of_birth	paris
lady_cynthia_mosley	parents	george_curzon_1st_marquess_curzon_of_kedleston
count_aage_of_rosenborg	parents	prince_valdemar_of_denmark
archduke_franz_karl_of_austria	nationality	austria
eleanor_of_spain	gender	female
princess_t_chi	spouse	emperor_kobun
feodor_iii_of_russia	gender	male
eleanor_of_castile	parents	ferdinand_iii_of_castile
robert_anderson_1917	nationality	united_states
chindasuinth	children	reccesuinth
empress_matilda	nationality	kingdom_of_england
robert_a_heinlein	cause_of_death	emphysema
prince_augustus_frederick_duke_of_sussex	parents	charlotte_of_mecklenburg-strelitz
seti_i	parents	ramesses_i
william_i_of_wurttemberg	spouse	catherine_pavlovna_of_russia
charles_v_holy_roman_emperor	spouse	isabella_of_portugal
archduchess_maria_beatrix_of_austria_este	children	carlos_duke_of_madrid
eleanor_wilson_mcadoo	spouse	william_gibbs_mcadoo
ramon_berenguer_ii_count_of_barcelona	parents	ramon_berenguer_i_count_of_barcelona
james_roosevelt_sr	place_of_death	new_york
yolande_of_aragon	parents	john_i_of_aragon
albert_iv_duke_of_bavaria	parents	albert_iii_duke_of_bavaria
ogden_mills	parents	darius_ogden_mills
prince_vasili_alexandrovich_of_russia	parents	grand_duchess_xenia_alexandrovna_of_russia
edward_of_norwich_2nd_duke_of_york	parents	edmund_of_langley_1st_duke_of_york
juliette_peirce	spouse	charles_peirce
conrad_iv_of_germany	parents	yolande_of_jerusalem
mayer_amschel_rothschild	nationality	germany
maximilian_iii_elector_of_bavaria	place_of_birth	munich
franz_liszt	nationality	hungary
anne_duchess_of_montpensier	gender	female
prince_augustus_william_of_prussia	gender	male
lady_louisa_stuart	parents	john_stuart_3rd_earl_of_bute
yixuan_1st_prince_chun	place_of_death	beijing
sophia_alekseyevna	parents	alexis_i_of_russia
francoise_daubigne_marquise_de_maintenon	spouse	louis_xiv_of_france
john_matthew_defeo	parents	ronald_defeo_sr
princess_louise_charlotte_of_denmark	gender	female
mary_boleyn	spouse	william_carey_1490
hermenegild	religion	catholicism
robert_i_of_scotland	spouse	isabella_of_mar
gussie_busch	parents	august_anheuser_busch_sr
john_i_of_denmark	parents	dorothea_of_brandenburg
princess_viktoria_of_prussia	nationality	germany
benjamin_disraeli_1st_earl_of_beaconsfield	gender	male
georg_grand_duke_of_mecklenburg_strelitz	gender	male
john_hays_hammond	children	john_hays_hammond_jr
elizabeth_of_rhuddlan	parents	eleanor_of_castile
albert_v_duke_of_bavaria	spouse	anna_of_austria
augusta_of_saxe-weimar	spouse	william_i_german_emperor
princess_mary_of_great_britain	gender	female
rose_fitzgerald_kennedy	parents	john_f_fitzgerald
maria_luisa_of_orleans	gender	female
isabel_de_clare_4th_countess_of_pembroke	children	eva_marshal
kunigunde_of_austria	spouse	albert_iv_duke_of_bavaria
louis_devreux	parents	philip_iii_of_france
archduke_anton_victor_of_austria	place_of_birth	florence
maximilian_ii_holy_roman_emperor	place_of_death	regensburg
catharina_of_sweden	gender	female
louis-philippe_of_france	children	antoine_duke_of_montpensier
ethelbert_of_wessex	parents	ethelwulf_of_wessex
augustus_iii_of_poland	children	marie_josephe_of_saxony
prince_feodor_alexandrovich_of_russia	location	saint_petersburg
george_iv_of_the_united_kingdom	place_of_death	windsor_castle
georg_grand_duke_of_mecklenburg_strelitz	place_of_birth	hanover
anastasia_of_montenegro	parents	nicholas_i_of_montenegro
grand_duchess_catherine_mikhailovna_of_russia	parents	grand_duke_michael_pavlovich_of_russia
stanley_armour_dunham	ethnicity	english_americans
louis_vi_of_france	religion	catholicism
james_ii_of_england	children	anne_of_great_britain
atia	children	augustus
constantine_vii	children	romanos_ii
gaston_duke_of_orleans	children	francoise_madeleine_dorleans
buster_keaton	cause_of_death	lung_cancer
melissa_stewart_newman	children	paul_newman
robert_i_of_scotland	ethnicity	scottish_people
claudine_rhedey_von_kis_rhede	children	francis_duke_of_teck
frederick_i_duke_of_saxe_gotha_altenburg	children	frederick_ii_duke_of_saxe_gotha_altenburg
wilhelmine_of_prussia	parents	frederick_william_ii_of_prussia
david_lloyd_george	place_of_birth	manchester_united_kingdom
hojo_masako	spouse	minamoto_no_yoritomo
elizabeth_of_york	spouse	henry_vii_of_england
mary_hallock_foote	profession	writer
maria_theresa_of_austria	place_of_birth	vienna
edward_r_murrow	ethnicity	germans
constantine_dragas	children	helena_draga
anthony_browne_1st_viscount_montagu	spouse	magdalen_dacre_viscountess_montagu
joan_crawford	gender	female
ottokar_i_of_bohemia	place_of_death	prague
nadejda_mountbatten_marchioness_of_milford_haven	gender	female
isabel_of_spain_princess_of_asturias	gender	female
clementine_churchill_baroness_spencer_churchill	children	randolph_churchill
prince_almos	nationality	hungary
princess_maria_josepha_of_saxony	nationality	germany
claudine_rhedey_von_kis_rhede	nationality	hungary
constantine_i	children	constans
princess_victoria_of_hesse_and_by_rhine	nationality	united_kingdom
alice_of_the_united_kingdom	place_of_birth	buckingham_palace
lady_sarah_wilson	nationality	united_kingdom
kamehameha_iii	place_of_death	honolulu
infante_carlos_count_of_molina	parents	maria_luisa_of_parma
ingrid_bergman	cause_of_death	lymphoma
regina_crown_princess_of_austria	parents	georg_iii_duke_of_saxe_meiningen
friedrich_ii_eugen_duke_of_wurttemberg	children	elisabeth_of_wurttemberg
dorothea_of_brandenburg	nationality	germany
elisabeth_of_bavaria	parents	maximilian_joseph_duke_in_bavaria
isabel_of_france	nationality	france
chulalongkorn	children	chudadhut_dharadilok
alfonso_vii_of_leon	gender	male
princess_leopoldina_of_brazil	cause_of_death	typhoid_fever
manuel_i_komnenos	spouse	maria_of_antioch
thursday_october_christian	place_of_birth	pitcairn_islands
murad_v	parents	abdulmecid
franchot_tone	institution	cornell_university
louis_i_de_bourbon_prince_de_conde	nationality	france
charles_of_viana	gender	male
ramesses_ii	gender	male
henry_iv_holy_roman_emperor	parents	agnes_de_poitou
ferdinand_ii_of_aragon	gender	male
haile_selassie_i_of_ethiopia	cause_of_death	allegedly_murdered
ferdinand_i_holy_roman_emperor	children	maria_of_habsburg_archduchess_of_austria
lovisa_of_sweden	children	haakon_vii_of_norway
titus_van_rijn	parents	rembrandt
harriot_eaton_stanton_blatch	institution	vassar_college
frederick_ii_landgrave_of_hesse	gender	male
maria_winteler_einstein	religion	jew
christina_of_saxony	parents	ernest_elector_of_saxony
henrietta_anne_stuart	children	maria_luisa_of_orleans
george_formby	gender	male
casimir_margrave_of_brandenburg_bayreuth	parents	susanna_of_bavaria
john_ii_casimir_of_poland	place_of_birth	krakow
teresa_wright	nationality	united_states
louise_of_hesse-kassel	children	maria_fyodorovna
frederick_ix_of_denmark	gender	male
prince_ludwig_of_hesse_and_by_rhine	place_of_birth	darmstadt
louis_xiii_of_france	religion	catholicism
charibert_i	parents	ingund_wife_of_clotaire_i
franz_joseph_i_of_austria	religion	catholicism
geoffrey_v_count_of_anjou	parents	fulk_of_jerusalem
solomon_r_guggenheim	nationality	united_states
alfonso_ix_of_leon	children	ferdinand_iii_of_castile
jacqueline_kennedy_onassis	nationality	united_states
cosimo_iii_de_medici_grand_duke_of_tuscany	religion	catholicism
prince_albert_victor_duke_of_clarence	institution	trinity_college_cambridge
pepin_i_of_aquitaine	parents	louis_the_pious
john_i_of_portugal	children	edward_of_portugal
qianlong_emperor	ethnicity	manchu
princess_mary_adelaide_of_cambridge	children	prince_francis_of_teck
isabella_of_castile	children	juan_prince_of_asturias
ferdinand_iv_grand_duke_of_tuscany	gender	male
grand_duke_alexander_mikhailovich_of_russia	children	prince_andrei_alexandrovich_of_russia
gustavus_adolphus_of_sweden	children	christina_of_sweden
albert_i_of_germany	children	rudolph_i_of_bohemia
princess_louise_victoire_dorleans_alencon	gender	female
alfonso_iv_deste	parents	francesco_i_deste
alfred_duke_of_saxe_coburg_and_gotha	location	windsor
richard_of_shrewsbury_1st_duke_of_york	parents	elizabeth_woodville
luis_i_of_portugal	parents	maria_ii_of_portugal
james_a_bayard_jr	nationality	united_states
henriette_adelaide_of_savoy	spouse	ferdinand_maria_elector_of_bavaria
constantine_xi	profession	eastern_roman_emperor
johann_conrad_weiser_sr	children	conrad_weiser
augustus_de_morgan	profession	philosopher
leatrice_joy	place_of_birth	new_orleans
princess_victoria_melita_of_edinburgh_and_saxe-coburg-gotha	children	kira_kirillovna_of_russia
frederick_william_i_of_prussia	gender	male
harald_iv_of_norway	children	inge_i_of_norway
katarzyna_barbara_radziwill	gender	female
kira_kirillovna_of_russia	parents	princess_victoria_melita_of_edinburgh_and_saxe-coburg-gotha
ferdinand_vi_of_spain	gender	male
william_i_german_emperor	place_of_birth	berlin
mary_of_teck	parents	francis_duke_of_teck
sybille_of_cleves	gender	female
william_henry_fitzhugh_lee	parents	mary_anna_custis_lee
prince_william_of_hesse	place_of_death	copenhagen
hermenegild	gender	male
louis_dauphin_de_france	children	louis_xviii_of_france
pulcheria	gender	female
albert_v_duke_of_bavaria	gender	male
joseph_p_kennedy_sr	children	patricia_kennedy_lawford
marie_antoinette_of_tuscany	children	ferdinand_iv_grand_duke_of_tuscany
christine_marie_of_france	children	francis_hyacinth_duke_of_savoy
yixin_prince_gong	parents	daoguang_emperor
eudoxia_of_moscow	gender	female
stephen_ii_count_of_blois	children	stephen_of_england
pelayo_of_asturias	children	favila_of_asturias
william_king_noel_1st_earl_of_lovelace	spouse	ada_lovelace
marie_therese_of_savoy	children	louis_antoine_duke_of_angouleme
ulrich_ii_count_of_ostfriesland	place_of_death	aurich
henry_ii_of_england	gender	male
baruch_leib_rosowsky	children	solomon_rosowsky
joseph_clemens_of_bavaria	place_of_birth	munich
ray_bridwell_white	parents	alma_bridwell_white
ferdinand_i_of_austria	place_of_birth	vienna
paul_newman	place_of_death	westport
jawaharlal_nehru	profession	politician
henry_the_lion	parents	henry_x_duke_of_bavaria
louis_hayward	spouse	ida_lupino
mette_marit_crown_princess_of_norway	parents	sven_o_hoiby
sweyn_i_of_denmark	children	canute_the_great
groucho_marx	parents	sam_marx
george_formby	parents	george_formby_ashton_under_lyne
maria_adelaide_of_austria	children	umberto_i_of_italy
ramesses_i	children	seti_i
alexander_cambridge_1st_earl_of_athlone	parents	princess_mary_adelaide_of_cambridge
thursday_october_christian	parents	fletcher_christian
john_george_iii_elector_of_saxony	children	augustus_ii_the_strong
charles_iii_of_spain	nationality	spain
princess_helene_of_orleans	children	tomislav_ii_of_croatia_4th_duke_of_aosta
amedeo_3rd_duke_of_aosta	parents	princess_helene_of_orleans
george_of_saxony	children	princess_mathilde_of_saxony
leonora_of_england	parents	eleanor_of_aquitaine
ferdinand_iv_grand_duke_of_tuscany	place_of_birth	florence
louise_juliana_of_nassau	place_of_death	konigsberg
charlie_soong	religion	methodism
william_starling_burgess	institution	harvard_university
rainier_iii_prince_of_monaco	gender	male
errol_flynn	profession	film_director
tyrone_power	profession	actor
susan_cullen-ward	spouse	leka_crown_prince_of_albania
algernon_percy_4th_duke_of_northumberland	parents	hugh_percy_2nd_duke_of_northumberland
judith_of_schweinfurt	nationality	germany
audrey_hepburn	cause_of_death	colorectal_cancer
joana_princess_of_beira	gender	female
caroline_of_bourbon_parma	parents	ferdinand_duke_of_parma
mary_stuart_countess_of_bute	nationality	united_kingdom
oliver_belmont	nationality	united_states
elizabeth_charlotte_princess_palatine	location	heidelberg
carlos_i_of_portugal	parents	luis_i_of_portugal
charles_brandon_1st_duke_of_suffolk	children	lady_frances_brandon
dante_gabriel_rossetti	religion	anglicanism
lew_cody	spouse	mabel_normand
olga_feodorovna_grand_duchess_of_russia	gender	female
henry_howard_6th_duke_of_norfolk	nationality	kingdom_of_england
harry_hay	profession	writer
elisabeth_st_michel	gender	female
william_kissam_vanderbilt	nationality	united_states
isabella_of_mar	gender	female
cecilia_renata_of_austria	gender	female
winston_churchill	profession	journalist
maria_pavlovna_of_russia	children	augusta_of_saxe-weimar
elisabeth_of_bavaria_1876	place_of_death	brussels
assia_wevill	location	london
grand_duke_michael_mihailovich_of_russia	gender	male
edward_vii_of_the_united_kingdom	institution	trinity_college_cambridge
prince_georg_of_bavaria	gender	male
maximilian_i_of_bavaria	nationality	germany
ali_adil_shah_ii	religion	muslim
john_stewart_2nd_earl_of_buchan	parents	robert_stewart_1st_duke_of_albany
oliver_belmont	gender	male
miguel_of_portugal	nationality	portugal
arleen_whelan	spouse	alexander_darcy
casimir_margrave_of_brandenburg_bayreuth	children	louis_vi_elector_palatine
isabella_ii_of_spain	location	madrid
theobald_ii_of_champagne	children	adele_of_champagne
carole_lombard	gender	female
archduchess_luise_princess_of_tuscany	parents	alice_of_bourbon_parma
bobby_troup	spouse	julie_london
nicholas_ii_of_russia	cause_of_death	regicide
sylvia_brett	profession	writer
louis_iii_prince_of_conde	children	charles_de_bourbon_charolais
marie_of_orleans	gender	female
archduke_charles_duke_of_teschen	nationality	austria
ibrahim_adil_shah_ii	religion	sunni_islam
marie_amalie_of_austria	parents	maria_theresa_of_austria
infante_joao_of_portugal	children	beatriz_of_portugal
edith_craig	parents	edward_william_godwin
sam_marx	children	harpo_marx
john_iii_sobieski	children	jakub_ludwik_sobieski
george_of_saxony	place_of_birth	dresden
tolui_borjigin	place_of_birth	mongolia
soong_may-ling	nationality	republic_of_china
pedro_v_of_portugal	gender	male
louise_of_mecklenburg-strelitz	children	prince_albert_of_prussia
skip_caray	profession	sportscaster
john_d_spreckels	nationality	united_states
sophia_of_prussia	gender	female
george_washington_parke_custis	gender	male
nelson_rockefeller	nationality	united_states
grand_duchess_elizabeth_mikhailovna	gender	female
rembrandt	location	amsterdam
frederick_howard_taylor	profession	missionary
chimalpopoca	parents	moctezuma_ii
charles_the_bald	children	louis_the_stammerer
princess_beatrice_of_the_united_kingdom	children	victoria_eugenia_of_battenberg
edouard_alphonse_de_rothschild	religion	judaism
gustav_iii_of_sweden	cause_of_death	firearm
thomas_thynne_1st_marquess_of_bath	nationality	united_kingdom
ted_hughes	spouse	assia_wevill
elena_pavlovna_of_wurttemberg	parents	prince_paul_of_wurttemberg
marie_of_edinburgh	children	princess_ileana_of_romania
charles_talbot_1st_baron_talbot_of_hensol	profession	lawyer
henry_i_duke_of_guise	gender	male
frederick_william_ii_of_prussia	location	berlin
anna_e_roosevelt	parents	franklin_d_roosevelt
kanteerava_narasimharaja_wadiyar	children	jayachamaraja_wodeyar_bahadur
philip_v_of_france	gender	male
eric_xiv_of_sweden	cause_of_death	poison
henry_howard_7th_duke_of_norfolk	parents	henry_howard_6th_duke_of_norfolk
edward_r_murrow	nationality	united_states
harry_caray	cause_of_death	cardiovascular_disease
pieter_brueghel_the_younger	parents	pieter_brueghel_the_elder
lord_george_lennox	nationality	united_kingdom
louisa_ulrika_of_prussia	place_of_birth	berlin
clotaire_i	spouse	radegund
aristotle_onassis	spouse	jacqueline_kennedy_onassis
kara_or_e_petrovic	cause_of_death	assassination
tintoretto	religion	catholicism
maximilian_i_of_bavaria	place_of_birth	schwetzingen
lady_jane_grey	cause_of_death	decapitation
leatrice_joy	place_of_death	riverdale_bronx
anne_duchess_of_maine	gender	female
james_e_robinson	children	pauline_robinson
marie_of_edinburgh	children	carol_ii_of_romania
lynn_redgrave	parents	michael_redgrave
simon_guggenheim	parents	meyer_guggenheim
francis_ii_holy_roman_emperor	parents	leopold_ii_holy_roman_emperor
george_of_denmark	nationality	denmark
john_f_fitzgerald	religion	catholicism
frederick_w_seward	gender	male
margaret_of_england	parents	eleanor_of_provence
prince_peter_of_greece_and_denmark	parents	princess_marie_bonaparte
ferdinand_ii_of_the_two_sicilies	parents	maria_isabella_of_spain
margaret_sullavan	gender	female
john_elector_of_saxony	children	john_frederick_elector_of_saxony
carlos_thompson	spouse	lilli_palmer
ernest_augustus_i_of_hanover	nationality	united_kingdom
ptolemy_iii_euergetes	parents	arsinoe_i_of_egypt
anna_sophia_ii_abbess_of_quedlinburg	parents	sophia_eleonore_of_saxony
david_carradine	parents	john_carradine
alexander_ferdinand_3rd_prince_of_thurn_and_taxis	religion	roman_catholic_church
george_ii_of_great_britain	parents	george_i_of_great_britain
prince_joachim_of_prussia	parents	william_ii_german_emperor
abigail_campbell_kawananakoa	parents	abigail_campbell
j_p_morgan	religion	anglicanism
louis_ix_of_france	children	philip_iii_of_france
j_p_morgan_jr	profession	banker
william_cavendish_bentinck_7th_duke_of_portland	nationality	united_kingdom
anahareo	spouse	grey_owl
miklos_horthy	spouse	magdolna_purgly
gustav_i_of_sweden	gender	male
robert_ii_of_scotland	gender	male
john_iii_of_sweden	children	sigismund_iii_vasa
brian_kelly_hell	institution	university_of_notre_dame
joan_of_acre	parents	edward_i_of_england
joseph_p_kennedy_sr	profession	politician
elena_pavlovna_of_wurttemberg	children	grand_duchess_elizabeth_mikhailovna
ordono_ii_of_leon	parents	alfonso_iii_of_leon
sophia_dorothea_of_hanover	parents	sophia_dorothea_of_celle
charles_edison	parents	thomas_edison
grand_duke_peter_nicolaievich_of_russia	children	princess_marina_petrovna_of_russia
amedeo_3rd_duke_of_aosta	cause_of_death	tuberculosis
margaret_beaufort	children	henry_vii_of_england
sorghaghtani_beki	children	mongke_khan
archduchess_luise_princess_of_tuscany	religion	roman_catholic_church
errol_flynn	profession	film_producer
yaropolk_izyaslavich	parents	iziaslav_i_of_kiev
charles_viii_of_france	spouse	anne_of_brittany
baidar	gender	male
colleen_dewhurst	spouse	george_c_scott
albert_of_saxe-coburg_and_gotha	gender	male
philip_iii_duke_of_burgundy	children	charles_i_duke_of_burgundy
louis_the_stammerer	children	charles_the_simple
ina_claire	spouse	john_gilbert_1899
tony_benn	nationality	united_kingdom
charlotte_de_rothschild	parents	james_mayer_de_rothschild
amadeus_ix_duke_of_savoy	parents	louis_duke_of_savoy
rembrandt	spouse	saskia_van_uylenburg
john_of_islay_lord_of_the_isles	spouse	elizabeth_mure
simone_signoret	gender	female
sigismund_iii_vasa	children	alexander_charles_vasa
princess_amelia_of_the_united_kingdom	cause_of_death	tuberculosis
margaret_de_bohun_2nd_countess_of_devon	parents	humphrey_de_bohun_4th_earl_of_hereford
philippe_i_duke_of_orleans	gender	male
christiane_eberhardine_of_brandenburg_bayreuth	children	augustus_iii_of_poland
akbar	gender	male
philipp_wilhelm_elector_palatine	place_of_death	vienna
infanta_beatriz_of_spain	parents	alfonso_xiii_of_spain
louise_juliana_of_nassau	parents	william_the_silent
chulalongkorn	parents	debsirindra
henry_i_duke_of_guise	cause_of_death	assassination
ramon_berenguer_iv_count_of_provence	parents	alfonso_ii_count_of_provence
frank_lloyd_wright	children	lloyd_wright
jacqueline_kennedy_onassis	institution	george_washington_university
emanuele_filiberto_2nd_duke_of_aosta	spouse	princess_helene_of_orleans
henry_herbert_10th_earl_of_pembroke	nationality	united_kingdom
vasili_ii_of_russia	gender	male
mariana_victoria_of_spain	nationality	portugal
elizabeth_cady_stanton	gender	female
frederick_v_of_denmark	gender	male
baldwin_v_count_of_flanders	children	matilda_of_flanders
albert_of_saxe-coburg_and_gotha	cause_of_death	typhoid_fever
charles_lennox_1st_duke_of_richmond	children	anne_van_keppel_countess_of_albemarle
noble_consort_wan	spouse	qianlong_emperor
linda_gallegos	spouse	gilbert_gallegos
matilda_of_flanders	children	henry_i_of_england
princess_ileana_of_romania	spouse	archduke_anton_prince_of_tuscany
francis_iv_duke_of_modena	religion	catholicism
henry_iii_of_castile	gender	male
charles_brandon_1st_duke_of_suffolk	nationality	kingdom_of_england
hudson_taylor	place_of_death	changsha
maria_christina_of_austria	children	infanta_maria_teresa_of_spain
charles_of_lorraine_duke_of_mayenne	gender	male
edwin_samuel_montagu	spouse	venetia_stanley_1887
yolande_of_jerusalem	parents	maria_of_montferrat
rose_mcconnell_long	gender	female
anna_deste	spouse	jacques_de_savoie_2nd_duc_de_nemours
grand_duke_dmitri_konstantinovich_of_russia	nationality	russia
ferdinando_iii_de_medici	parents	marguerite_louise_dorleans
maximilian_i_of_bavaria	children	princess_amalie_auguste_of_bavaria
hasan_al-askari	religion	shia_islam
john_ii_casimir_of_poland	place_of_death	nevers
alfonso_de_orleans_y_borbon	spouse	princess_beatrice_of_edinburgh_and_saxe-coburg-gotha
john_stuart_3rd_earl_of_bute	nationality	scotland
grand_duke_nicholas_alexandrovich_of_russia	parents	maria_alexandrovna_of_hesse
richilde_of_provence	spouse	charles_the_bald
chiang_wei-kuo	parents	soong_may-ling
wladyslaw_czartoryski	parents	adam_jerzy_czartoryski
augusta_of_saxe-weimar	children	princess_louise_of_prussia
karin_mansdotter	spouse	eric_xiv_of_sweden
paul_newman	gender	male
john_spencer_churchill_7th_duke_of_marlborough	children	lord_randolph_churchill
anna_e_roosevelt	gender	female
eleanor_of_provence	children	beatrice_of_england
james_ii_of_england	children	mary_ii_of_england
willem_van_keppel_2nd_earl_of_albemarle	children	augustus_keppel_1st_viscount_keppel
henry_viii_of_england	gender	male
elizabeth_woodville	children	anne_of_york
johann_wilhelm_elector_palatine	nationality	germany
ottavio_farnese_duke_of_parma	children	alexander_farnese_duke_of_parma
frederick_viii_of_denmark	gender	male
maria_ii_of_portugal	religion	catholicism
abigail_campbell_kawananakoa	gender	female
victoria_princess_royal	children	sophia_of_prussia
miguel_ii_duke_of_braganza	parents	miguel_of_portugal
henrietta_anne_stuart	spouse	philippe_i_duke_of_orleans
princess_viktoria_of_prussia	parents	frederick_iii_german_emperor
ottokar_i_of_bohemia	children	agnes_of_bohemia
louis_iv_holy_roman_emperor	children	louis_v_duke_of_bavaria
george_v_of_the_united_kingdom	children	mary_princess_royal_and_countess_of_harewood
princess_charlotte_of_prussia	gender	female
manuel_ii_palaiologos	children	john_viii_palaiologos
frederick_william_iii_of_prussia	children	princess_alexandrine_of_prussia
eleanor_of_aquitaine	location	aquitaine
faisal_ii_of_iraq	institution	harrow_school
sophia_alekseyevna	ethnicity	russians
isabella_of_england	spouse	frederick_ii_holy_roman_emperor
barbu_stirbey	children	prince_mircea_of_romania
joe_keaton	profession	actor
mahatma_gandhi	profession	politician
elisabeth_marguerite_of_orleans	parents	marguerite_duchess_of_orleans
archduke_otto_franz_of_austria	parents	archduke_carl_ludwig_of_austria
alexandrine_of_mecklenburg-schwerin	spouse	christian_x_of_denmark
gaston_comte_deu	nationality	france
edward_of_portugal	children	afonso_v_of_portugal
ted_hughes	gender	male
edward_i_of_england	children	margaret_plantagenet
john_i_of_aragon	parents	peter_iv_of_aragon
alia_al_hussein	gender	female
lilli_palmer	spouse	rex_harrison
groucho_marx	place_of_death	los_angeles
christian_ii_elector_of_saxony	parents	christian_i_elector_of_saxony
chiang_kai-shek	spouse	mao_fumei
harry_caray	profession	sportscaster
john_b_kelly_sr	gender	male
marie_antoinette	place_of_death	place_de_la_concorde
henry_the_lion	religion	catholicism
louis_xiv_of_france	religion	catholicism
blanche_of_burgundy	spouse	charles_iv_of_france
george_iv_of_the_united_kingdom	spouse	caroline_of_brunswick
hortense_de_beauharnais	parents	josephine_de_beauharnais
alexandre_vicomte_de_beauharnais	children	hortense_de_beauharnais
nathan_mayer_rothschild	nationality	united_kingdom
anne_of_denmark	children	henry_frederick_prince_of_wales
princess_viktoria_luise_of_prussia	place_of_birth	potsdam
charles_v_holy_roman_emperor	religion	catholicism
julius_caesar	location	rome
srinagarindra	children	ananda_mahidol
edward_r_murrow	location	brooklyn
ghazi_of_iraq	place_of_birth	mecca
ramon_magsaysay	spouse	luz_magsaysay
fredegund	gender	female
benjamin_peirce	profession	librarian
prince_rupert_of_the_rhine	nationality	germany
louis_dauphin_de_france	cause_of_death	tuberculosis
princess_louise_of_denmark_and_norway	place_of_birth	christiansborg_palace
otto_iii_holy_roman_emperor	cause_of_death	malaria
frederick_v_of_denmark	place_of_death	christiansborg_palace
anne_van_keppel_countess_of_albemarle	gender	female
grand_duchess_xenia_alexandrovna_of_russia	parents	alexander_iii_of_russia
maria_victoria_al_pozzo_della_cisterna	spouse	amadeo_i_of_spain
elisabeth_of_wurttemberg	spouse	francis_ii_holy_roman_emperor
albert_i_of_germany	cause_of_death	assassination
anna_e_roosevelt	parents	eleanor_roosevelt
adelaide_of_saxe-meiningen	parents	georg_i_frederick_karl_duke_of_saxe_meiningen
nathan_mayer_rothschild	children	lionel_de_rothschild
grand_duke_alexei_mikhailovich_of_russia	place_of_birth	tbilisi
wladyslaw_i_herman	gender	male
prince_henry_duke_of_gloucester	parents	mary_of_teck
empress_xiaomu	spouse	daoguang_emperor
walter_devereux_1st_earl_of_essex	cause_of_death	dysentery
violante_of_bavaria	place_of_birth	munich
archduke_frederick_ferdinand_of_austria	gender	male
james_mayer_de_rothschild	profession	banker
magnus_i_of_norway	parents	olaf_ii_of_norway
alphonse_james_de_rothschild	religion	judaism
mihailo_obrenovic_iii_prince_of_serbia	parents	milo_obrenovic_i_prince_of_serbia
princess_sophia_dorothea_of_prussia	parents	sophia_dorothea_of_hanover
margaret_of_artois	spouse	louis_devreux
margaret_mead	spouse	gregory_bateson
sigismund_iii_vasa	religion	catholicism
pauline_robinson	nationality	united_states
perkin_warbeck	place_of_birth	tournai
adelaide_of_aquitaine	children	adele_of_france
prince_heinrich_of_prussia	gender	male
cleopatra_selene	parents	cleopatra_vii_of_egypt
irene_joliot-curie	place_of_birth	paris
philip_ii_of_france	spouse	ingeborg_of_denmark_queen_consort_of_france
christian_ii_of_denmark	parents	christina_of_saxony
frances_polidori	gender	female
charles_iv_of_spain	parents	maria_amalia_of_saxony
eleanor_of_alburquerque	children	john_ii_of_aragon
josephine_de_beauharnais	children	hortense_de_beauharnais
ptolemy_ix_lathyros	spouse	cleopatra_iv_of_egypt
grand_duchess_xenia_alexandrovna_of_russia	children	prince_nikita_of_russia
narisara_nuvadtivongs	gender	male
alva_belmont	location	mobile
otto_i_duke_of_brunswick_luneburg	parents	helen_daughter_of_king_valdemar_i_of_denmark
henry_stanton	children	harriot_eaton_stanton_blatch
shuja-ud-daula	children	saadat_ali_khan
joseph_p_kennedy_jr	institution	choate_rosemary_hall
nissanka_wijeyeratne	parents	edwin_wijeyeratne
isabel_princess_imperial_of_brazil	nationality	portugal
hugh_percy_2nd_duke_of_northumberland	children	algernon_percy_4th_duke_of_northumberland
roza_laborfalvi	spouse	mor_jokai
nelson_rockefeller	cause_of_death	myocardial_infarction
john_stuart_3rd_earl_of_bute	institution	eton_college
constantine_dragas	gender	male
francis_duke_of_teck	parents	claudine_rhedey_von_kis_rhede
mariana_victoria_of_spain	spouse	joseph_i_of_portugal
marguerite_of_france_1158	spouse	henry_the_young_king
ferdinand_ii_of_aragon	parents	john_ii_of_aragon
benjamin_harrison	institution	miami_university
phillip_terry	spouse	joan_crawford
mary_of_york	place_of_birth	windsor_castle
theodore_roosevelt_sr	gender	male
john_i_of_castile	spouse	beatrice_of_portugal
maria_amalia_of_austria	children	louis_of_etruria
kekauluohi_likelike	children	kaiulani
princess_beatrice_of_edinburgh_and_saxe-coburg-gotha	parents	maria_alexandrovna_of_russia
john_of_gaunt_1st_duke_of_lancaster	spouse	blanche_of_lancaster
lili_damita	spouse	michael_curtiz
claude_of_valois	gender	female
borte	gender	female
anna_lee	spouse	robert_stevenson_1905
adelheid_i_abbess_of_quedlinburg	place_of_death	quedlinburg_abbey
henry_iii_of_france	profession	monarch
maud_of_wales	spouse	haakon_vii_of_norway
christopher_columbus	children	fernando_colon
guillaume_iv_grand_duke_of_luxembourg	parents	adolphe_grand_duke_of_luxembourg
franchot_tone	gender	male
elisabeth_of_bavaria	children	archduchess_sophie_of_austria
joan_i_of_navarre	spouse	philip_iv_of_france
frederick_v_elector_palatine	gender	male
joan_of_england_queen_of_sicily	parents	henry_ii_of_england
talal_of_jordan	gender	male
rasmus_bartholin	parents	caspar_bartholin_the_elder
victor_amadeus_iii_of_sardinia	parents	charles_emmanuel_iii_of_sardinia
adelaide_of_lowenstein_wertheim_rosenberg	location	bavaria
princess_mafalda_of_italy	place_of_birth	rome
william_herbert_1st_earl_of_pembroke	children	henry_herbert_2nd_earl_of_pembroke
alfonso_xiii_of_spain	place_of_birth	madrid
sophia_charlotte_of_hanover	children	frederick_william_i_of_prussia
william_i_of_england	children	robert_iii_duke_of_normandy
alexander_ferdinand_3rd_prince_of_thurn_and_taxis	children	karl_anselm_4th_prince_of_thurn_and_taxis
nikephoros_ii	gender	male
adelaide_of_saxe-meiningen	gender	female
ann_dunham	ethnicity	french_american
elizabeth_bourchier	spouse	oliver_cromwell
iziaslav_i_of_kiev	parents	olof_of_sweden
princess_louise_duchess_of_argyll	parents	albert_of_saxe-coburg_and_gotha
jacqueline_kennedy_onassis	ethnicity	french_american
mary_princess_royal_and_countess_of_harewood	place_of_birth	sandringham
thomas_edison	ethnicity	dutch-americans
eleanor_de_roucy_de_roye	children	francois_de_bourbon_prince_de_conti
j_p_morgan_jr	parents	j_p_morgan
ogden_l_mills	nationality	united_states
sviatoslav_ii_of_kiev	parents	olof_of_sweden
william_the_silent	cause_of_death	firearm
rembrandt	nationality	netherlands
murad_ii	gender	male
marguerite_de_valois	parents	henry_ii_of_france
frits_philips	cause_of_death	accidental_fall
manuel_i_komnenos	gender	male
william_gibbs_mcadoo	profession	politician
francis_i_holy_roman_emperor	children	archduchess_maria_anna
leka_crown_prince_of_albania	parents	zog_of_albania
amadeo_i_of_spain	parents	maria_adelaide_of_austria
augustus_iii_of_poland	place_of_death	dresden
archduke_carl_ludwig_of_austria	gender	male
william_wyler	nationality	france
ramon_berenguer_iii_count_of_barcelona	children	ramon_berenguer_iv_count_of_barcelona
john_i_of_portugal	gender	male
leopold_grand_duke_of_baden	place_of_birth	karlsruhe
colleen_dewhurst	profession	actor
louis_armand_ii_de_bourbon_prince_de_conti	spouse	louise_elisabeth_de_bourbon_conde
isabella_of_castile	children	joanna_of_castile
natalya_alexeevna	profession	playwright
adolphus_busch_iii	profession	businessperson
infante_carlos_count_of_molina	nationality	spain
bretislaus_ii_of_bohemia	parents	vratislaus_ii_of_bohemia
romanos_ii	children	basil_ii
svante_nilsson	children	sten_sture_the_younger
nicholas_i_of_montenegro	place_of_birth	njegusi
charles_duke_of_lower_lorraine	parents	louis_iv_of_france
groucho_marx	cause_of_death	pneumonia
paul_i_of_russia	nationality	russia
george_formby_ashton_under_lyne	gender	male
hudson_taylor	children	frederick_howard_taylor
david_lloyd_george	nationality	wales
georg_donatus_hereditary_grand_duke_of_hesse	children	prince_ludwig_of_hesse_and_by_rhine
ferdinand_i_of_romania	parents	infanta_antonia_of_portugal
isabella_of_burgundy	parents	philip_i_of_castile
otto_iii_holy_roman_emperor	parents	theophanu
albert_i_of_saxony	institution	university_of_bonn
infante_fernando_duke_of_viseu	children	manuel_i_of_portugal
john_gilbert_1899	spouse	leatrice_joy
elizabeth_of_bohemia	profession	poet
marie_louise_duchess_of_parma	spouse	adam_albert_von_neipperg
claudius	location	lyon
catherine_de_medici	parents	madeleine_de_la_tour_dauvergne
august_anheuser_busch_sr	nationality	germany
franklin_d_roosevelt	cause_of_death	cerebral_hemorrhage
leopold_grand_duke_of_baden	children	olga_feodorovna_grand_duchess_of_russia
edward_blake	spouse	george_mackinnon_wrong
richard_1st_earl_of_cornwall	parents	john_of_england
malcolm_iv_of_scotland	parents	ada_de_warenne
empress_myeongseong	cause_of_death	regicide
albert_i_of_germany	spouse	elisabeth_of_tirol
louis-philippe_of_france	spouse	maria_amalia_of_the_two_sicilies
leopold_iii_of_belgium	spouse	lilian_baels
karen_sparck_jones	nationality	united_kingdom
grey_owl	place_of_death	prince_albert
prince_ludwig_of_hesse_and_by_rhine	gender	male
adolphe_grand_duke_of_luxembourg	spouse	grand_duchess_elizabeth_mikhailovna
stephanie_of_hohenzollern_sigmaringen	spouse	pedro_v_of_portugal
james_otis	cause_of_death	lightning
vratislaus_ii_of_bohemia	parents	judith_of_schweinfurt
robert_stevenson_1905	profession	screenwriter
isabella_of_england	place_of_death	foggia
christian_i_elector_of_saxony	children	christian_ii_elector_of_saxony
bezmialem	religion	islam
marie_sophie_of_hesse-kassel	parents	princess_louise_of_denmark_and_norway
christian_ii_of_denmark	parents	john_i_of_denmark
princess_josephine_of_baden	children	stephanie_of_hohenzollern_sigmaringen
princess_mathilde_of_saxony	parents	george_of_saxony
archduchess_gisela_of_austria	gender	female
elizabeth_cady_stanton	religion	atheism
wilfrid_scawen_blunt	spouse	lady_anne_blunt
theodosius_ii	gender	male
john_a_roebling	profession	architect
franz_joseph_i_of_austria	spouse	elisabeth_of_bavaria
edward_william_godwin	profession	architect
john_barrymore	place_of_birth	philadelphia
ingrid_bergman	spouse	roberto_rossellini
nicholas_ii_of_russia	location	moscow
qianlong_emperor	parents	yongzheng_emperor
princess_leopoldina_of_brazil	nationality	portugal
theodosius_ii	parents	aelia_eudoxia
count_alexei_alexandrovich_belevsky_zhukovsky	gender	male
george_of_saxony	children	prince_johann_georg_of_saxony
elisabeth_of_france	parents	marie_de_medici
alexandra_iosifovna_of_altenburg	place_of_death	saint_petersburg
domenico_tintoretto	parents	tintoretto
prince_albert_of_prussia	gender	male
adolf_frederick_of_sweden	children	gustav_iii_of_sweden
mary_boleyn	parents	elizabeth_boleyn_countess_of_wiltshire
ulrich_ii_count_of_ostfriesland	parents	enno_iii_count_of_ostfriesland
sophia_dorothea_of_hanover	place_of_birth	hanover
princess_cecilie_of_greece_and_denmark	children	prince_ludwig_of_hesse_and_by_rhine
alexandra_fyodorovna_of_hesse	cause_of_death	murder
marie_louise_duchess_of_parma	spouse	napoleon_i_of_france
casimir_i_of_poland	children	wladyslaw_i_herman
anna_of_savoy	gender	female
maria_isabella_of_spain	religion	roman_catholic_church
michael_redgrave	location	bristol
charles_anthoni_johnson_brooke	place_of_birth	burnham-on-sea
grace_kelly	profession	fashion_model
minnie_marx	spouse	sam_marx
john_lennon	parents	julia_lennon
thomas_jefferson	gender	male
chulalongkorn	children	yugala_dighambara
mary_i_of_scotland	cause_of_death	decapitation
victoria_princess_royal	parents	victoria_of_the_united_kingdom
franklin_d_roosevelt	institution	groton_school
haile_selassie_i_of_ethiopia	children	princess_tsehai
karol_stanislaw_radziwill	children	katarzyna_barbara_radziwill
robert_ii_of_france	gender	male
charles_xiii_of_sweden	gender	male
christian_bohr	gender	male
ethelwulf_of_wessex	gender	male
marcus_vipsanius_agrippa	gender	male
nicholas_hughes	cause_of_death	suicide
charles_ix_of_france	gender	male
kishore_kumar	cause_of_death	cardiovascular_disease
constantine_viii	children	theodora_0984
frederick_christian_elector_of_saxony	children	anthony_clement_of_saxony
elena_of_greece_and_denmark	gender	female
claudius	parents	antonia_minor
john_i_of_aragon	children	yolande_of_aragon
samuel_phillips_lee	profession	naval_officer
john_lennon	cause_of_death	assassination
grand_duchess_elizabeth_mikhailovna	spouse	adolphe_grand_duke_of_luxembourg
edward_smith_stanley_13th_earl_of_derby	institution	trinity_college_cambridge
boots_mallory	profession	actor
faisal_ii_of_iraq	parents	ghazi_of_iraq
anne_of_bohemia	gender	female
pesach_burstein	profession	singer
techichpotzin	place_of_birth	tenochtitlan
prince_francis_joseph_of_braganza	parents	miguel_ii_duke_of_braganza
william_ii_german_emperor	cause_of_death	pulmonary_embolism
eleanor_of_castile	children	margaret_plantagenet
mary_somerset_duchess_of_beaufort	parents	adolphus_cambridge_1st_marquess_of_cambridge
prince_gustav_adolf_duke_of_vasterbotten	nationality	sweden
patriarch_ignatios_of_constantinople	gender	male
napoleon_i_of_france	gender	male
gustav_i_of_sweden	children	princess_elizabeth_of_sweden
thomas_lamb_eliot	parents	william_greenleaf_eliot
maria_of_habsburg_archduchess_of_austria	parents	anna_of_bohemia_and_hungary
edward_blake	gender	male
wallace_reid	place_of_death	los_angeles
rex_harrison	location	fire_island
james_smithson	profession	mineralogist
thomas_thynne_1st_marquess_of_bath	profession	politician
amadeus_ix_duke_of_savoy	nationality	italy
alice_of_bourbon_parma	spouse	ferdinand_iv_grand_duke_of_tuscany
prince_arthur_duke_of_connaught_and_strathearn	nationality	united_kingdom
alexander_serov	place_of_birth	saint_petersburg
alexandra_fyodorovna_of_hesse	location	darmstadt
frederick_augustus_i_of_saxony	parents	frederick_christian_elector_of_saxony
prince_william_of_hesse	children	louise_of_hesse-kassel
gheorghe_tasca	profession	politician
laura_devon	gender	female
taufaahau_tupou_iv	profession	politician
wilhelmine_of_bayreuth	nationality	germany
isabella_of_jerusalem	place_of_birth	nablus
berenice_ii	spouse	ptolemy_iii_euergetes
wladyslaw_iv_vasa	gender	male
napoleon_i_of_france	religion	catholicism
robert_lowell	spouse	caroline_blackwood
frederica_of_mecklenburg-strelitz	spouse	ernest_augustus_i_of_hanover
ronald_defeo_sr	cause_of_death	homicide
rasmus_bartholin	place_of_birth	roskilde
yves_montand	nationality	italy
robert_c_wickliffe	parents	charles_a_wickliffe
ferdinand_i_of_romania	gender	male
mary_ii_of_england	cause_of_death	smallpox
sancho_iii_of_castile	gender	male
maria_anna_of_austria	nationality	austria
abigail_campbell	nationality	kingdom_of_hawaii
philippa_of_england	nationality	england
hippolyte_carnot	nationality	france
john_spencer_churchill_7th_duke_of_marlborough	nationality	united_kingdom
elisabeth_of_tirol	gender	female
domitilla_the_elder	spouse	vespasian
john_elector_of_saxony	nationality	germany
grand_duke_george_mikhailovich_of_russia	parents	olga_feodorovna_grand_duchess_of_russia
pauline_robinson	parents	james_e_robinson
auguste_van_pels	gender	female
augustus	profession	roman_emperor
jayachamaraja_wodeyar_bahadur	parents	kanteerava_narasimharaja_wadiyar
rudolph_i_of_bohemia	cause_of_death	dysentery
princess_margaretha_of_saxony	spouse	archduke_carl_ludwig_of_austria
john_of_england	children	eleanor_of_england
grand_duchess_alexandra_petrovna	children	grand_duke_nicholas_nicolaevich_the_younger
therese_of_saxe_hildburghausen	children	princess_adelgunde_of_bavaria
elena_of_greece_and_denmark	parents	sophia_of_prussia
john_f_kennedy_jr	profession	socialite
karl_ludwig_of_baden	place_of_birth	karlsruhe
leonard_jerome	children	jennie_churchill
ludwig_ii_of_bavaria	cause_of_death	drowning
lloyd_wright	nationality	united_states
john_campbell_9th_duke_of_argyll	spouse	princess_louise_duchess_of_argyll
alexandra_pavlovna_of_russia	place_of_death	vienna
aurangzeb	gender	male
marie_louise_duchess_of_parma	gender	female
doris_dowling	spouse	artie_shaw
grand_duchess_maria_nikolaevna_of_russia	place_of_birth	peterhof
helena_of_moscow	spouse	alexander_jagiellon
alfonso_xiii_of_spain	nationality	spain
charlemagne	gender	male
adam_jerzy_czartoryski	profession	author
buster_keaton	parents	joe_keaton
basil_ii	parents	nikephoros_ii
adolf_frederick_i_duke_of_mecklenburg_schwerin	gender	male
roy_o_disney	place_of_death	burbank
robert_iii_duke_of_normandy	gender	male
ferdinand_ii_of_leon	parents	alfonso_vii_of_leon
ruth_roland	spouse	ben_bard
ealhswith	profession	nun
gunnery_sergeant_john_e_mullin	children	charles_e_mullen
louis_ix_of_france	parents	louis_viii_of_france
princess_helene_of_orleans	spouse	emanuele_filiberto_2nd_duke_of_aosta
adelheid_i_abbess_of_quedlinburg	parents	theophanu
john_stuart_3rd_earl_of_bute	gender	male
matilda_of_ringelheim	gender	female
lynne_frederick	nationality	england
clotaire_i	gender	male
pulcheria	parents	arcadius
sigismund_i_the_old	parents	casimir_iv_jagiellon
ferdinand_georg_of_saxe-coburg-gotha	nationality	germany
artavasdes_i_of_armenia	children	tigranes_the_great
cleopatra_vii_of_egypt	children	caesarion
emanuele_filiberto_2nd_duke_of_aosta	nationality	italy
henry_iii_of_england	spouse	eleanor_of_provence
prince_louis_ferdinand_of_bavaria	gender	male
maria_luisa_of_savoy	cause_of_death	tuberculosis
hugh_percy_2nd_duke_of_northumberland	children	hugh_percy_3rd_duke_of_northumberland
blanche_of_lancaster	gender	female
rani_mangammal	spouse	chokkanatha_nayak
john_v_palaiologos	children	manuel_ii_palaiologos
galla_placidia	place_of_death	rome
louis_armand_i_prince_of_conti	place_of_death	fontainebleau
paul_i_of_russia	cause_of_death	regicide
ines_mendoza	profession	first_lady
henry_herbert_10th_earl_of_pembroke	children	sidney_herbert_1st_baron_herbert_of_lea
christian_x_of_denmark	place_of_death	amalienborg_palace
tolui_borjigin	children	mongke_khan
helen_vinson	profession	actor
feodor_iii_of_russia	parents	alexis_i_of_russia
effie_gray	spouse	john_ruskin
joseph_p_kennedy_sr	children	rosemary_kennedy
marie_de_medici	children	christine_marie_of_france
robert_i_duke_of_burgundy	children	constance_of_burgundy
maria_of_brabant	spouse	philip_iii_of_france
archduchess_maria_theresia_of_austria	parents	leopold_ii_holy_roman_emperor
louis_xvii_of_france	religion	catholicism
grand_duchess_xenia_alexandrovna_of_russia	location	saint_petersburg
abraham	spouse	sarah
stephanie_crowe	place_of_death	escondido
archduke_carl_ludwig_of_austria	place_of_death	vienna
katherine_mortimer_countess_of_warwick	nationality	kingdom_of_england
elisabeth_marguerite_of_orleans	nationality	kingdom_of_france
gojong_of_korea	parents	daewon-gun
anna_pavlovna_of_russia	gender	female
louis_xiii_of_france	children	louis_xiv_of_france
albert_of_saxe-coburg_and_gotha	children	alice_of_the_united_kingdom
crown_prince_wilhelm_of_germany	children	prince_frederick_of_prussia
archduke_franz_ferdinand_of_austria	cause_of_death	firearm
ferdinando_stanley_5th_earl_of_derby	gender	male
philip_v_of_spain	children	charles_iii_of_spain
roy_e_disney	location	newport_beach
canute_the_great	parents	sigrid_the_haughty
constance_of_aragon	spouse	frederick_ii_holy_roman_emperor
guido_deiro	gender	male
julia_grant	children	frederick_dent_grant
sylvia_plath	profession	poet
prince_christian_victor_of_schleswig-holstein	nationality	united_kingdom
tyrone_power_sr	gender	male
john_d_rockefeller_jr	profession	philanthropist
charlotte_of_mecklenburg-strelitz	gender	female
saadat_ali_khan	children	muhammad_ali_shah
freddie_lennon	location	liverpool
malcolm_iv_of_scotland	parents	henry_of_scotland_3rd_earl_of_huntingdon
barbara_of_portugal	gender	female
richard_mulligan	profession	actor
charles_iv_of_france	spouse	jeanne_devreux
ramon_magsaysay	nationality	philippines
eunice_kennedy_shriver	location	hyannis
charles_vyner_brooke	parents	charles_anthoni_johnson_brooke
aelia_eudoxia	spouse	arcadius
gaetano_polidori	place_of_death	london
john_gilbert_1899	place_of_death	hollywood
archduke_louis_of_austria	parents	leopold_ii_holy_roman_emperor
richard_burton	profession	actor
grey_owl	nationality	united_states
princess_anna_amalia_of_prussia	parents	frederick_william_i_of_prussia
belle_starr	children	pearl_starr
freddie_lennon	spouse	julia_lennon
chiang_kai-shek	religion	methodism
richard_de_clare_2nd_earl_of_pembroke	children	isabel_de_clare_4th_countess_of_pembroke
marie_antoinette_of_tuscany	gender	female
solomon_rosowsky	profession	hazzan
charles_darwin	institution	christs_college_cambridge
arcadius	spouse	aelia_eudoxia
edward_ellice_1810	parents	edward_ellice
john_rolfe	children	thomas_rolfe
walter_devereux_1st_earl_of_essex	gender	male
mongkut	children	chulalongkorn
harilal_gandhi	parents	kasturba_gandhi
louise_of_mecklenburg-strelitz	children	alexandra_fyodorovna
mahmud_ghazan	religion	islam
john_ruskin	institution	christ_church_oxford
dara_shikoh	parents	shah_jahan
maud_of_wales	parents	alexandra_of_denmark
akbar	location	agra
prince_sigismund_of_prussia	cause_of_death	meningitis
robert_i_of_artois	parents	blanche_of_castile
philippa_of_hainault	place_of_death	windsor_castle
jacqueline_kennedy_onassis	profession	book_editor
lilian_baels	spouse	leopold_iii_of_belgium
a_k_faezul_huq	parents	a_k_fazlul_huq
william_h_seward	gender	female
daewon-gun	children	gojong_of_korea
samuel_pepys	spouse	elisabeth_st_michel
frederick_william_iii_of_prussia	gender	male
manuel_i_of_portugal	gender	male
alexandra_fyodorovna	nationality	russia
olof_of_sweden	gender	male
evelyn_keyes	cause_of_death	alzheimers_disease
charlotte_of_mecklenburg-strelitz	children	prince_alfred_of_great_britain
athelstan_of_england	parents	edward_the_elder
princess_leopoldina_of_brazil	place_of_death	vienna
frank_reicher	parents	emanuel_reicher
william_henry_vanderbilt	parents	cornelius_vanderbilt
john_vi_of_portugal	nationality	portugal
charles_iv_of_spain	place_of_death	rome
bhanurangsi_savangwongse	parents	mongkut
pieter_brueghel_the_elder	gender	male
henry_iii_of_france	parents	catherine_de_medici
eleanor_roosevelt	profession	social_activist
ferdinand_iii_of_castile	parents	alfonso_ix_of_leon
frederick_ii_landgrave_of_hesse	place_of_death	kassel
anne_of_brittany	gender	female
diana_barrymore	nationality	united_states
eva_braun	cause_of_death	suicide
princess_louise_elisabeth_of_france	cause_of_death	smallpox
robert_mackay	ethnicity	scottish_canadian
harriot_eaton_stanton_blatch	place_of_death	greenwich_connecticut
john_of_gaunt_1st_duke_of_lancaster	nationality	kingdom_of_england
sigrid_the_haughty	parents	mieszko_i_of_poland
stanley_armour_dunham	ethnicity	white_american
yves_montand	spouse	simone_signoret
ingrid_bergman	place_of_death	london
ida_lupino	spouse	louis_hayward
sylvia_plath	profession	writer
kashta	children	piye
william_the_silent	cause_of_death	assassination
ada_lovelace	nationality	united_kingdom
maria_anna_of_austria	children	ferdinand_maria_elector_of_bavaria
james_hepburn_4th_earl_of_bothwell	spouse	mary_i_of_scotland
alice_of_the_united_kingdom	cause_of_death	infectious_disease
marie_francois_sadi_carnot	parents	hippolyte_carnot
ellen_terry	gender	female
j_p_morgan_jr	gender	male
gunnery_sergeant_john_e_mullin	nationality	united_states
atia	religion	roman_mythology
maria_annunciata_of_the_two_sicilies	cause_of_death	tuberculosis
liudolf_duke_of_saxony	children	liutgard
ferdinand_ii_of_portugal	children	luis_i_of_portugal
david_kawananakoa	children	abigail_kapiolani_kawananakoa
frederick_v_of_denmark	parents	sophia_magdalen_of_brandenburg-kulmbach
anna_katarzyna_sanguszko	gender	female
ramon_berenguer_iii_count_of_barcelona	gender	male
aurangzeb	religion	islam
salote_tupou_iii_of_tonga	institution	new_zealand
rudolf_christian_count_of_ostfriesland	parents	enno_iii_count_of_ostfriesland
sherman_hoar	institution	harvard_university
barbara_of_portugal	nationality	portugal
philippa_of_hainault	gender	female
louis_xiv_of_france	children	louise_marie_anne_de_bourbon
taufaahau_tupou_iv	ethnicity	tongans
louis_philippe_i_duke_of_orleans	parents	auguste_marie_johanna_of_baden_baden
edward_salisbury_dana	parents	james_dwight_dana
william_kissam_vanderbilt	parents	william_henry_vanderbilt
ranuccio_i_farnese_duke_of_parma	parents	alexander_farnese_duke_of_parma
amadeo_i_of_spain	children	luigi_amedeo_duke_of_the_abruzzi
sophia_dorothea_of_celle	children	sophia_dorothea_of_hanover
ferdinand_i_holy_roman_emperor	children	johanna_of_austria
elizabeth_bourchier	gender	female
cheryl_crowe	children	stephanie_crowe
edward_r_murrow	cause_of_death	lung_cancer
james_mayer_de_rothschild	parents	mayer_amschel_rothschild
frederick_iii_german_emperor	parents	william_i_german_emperor
sylvia_plath	cause_of_death	suicide
hermann_einstein	nationality	germany
daoguang_emperor	gender	male
augustus_iii_of_poland	parents	christiane_eberhardine_of_brandenburg_bayreuth
audrey_hepburn	spouse	mel_ferrer
h_p_lovecraft	spouse	sonia_greene
iziaslav_i_of_kiev	gender	male
regina_crown_princess_of_austria	spouse	otto_von_habsburg
baudouin_of_belgium	cause_of_death	cardiovascular_disease
magdalen_dacre_viscountess_montagu	spouse	anthony_browne_1st_viscount_montagu
charlotte_duchess_of_albany	parents	charles_edward_stuart
martha_jefferson_randolph	gender	female
caroline_webster_schermerhorn_astor	nationality	united_states
henry_iv_holy_roman_emperor	parents	henry_iii_holy_roman_emperor
ben_bard	gender	male
lady_anne_blunt	parents	william_king_noel_1st_earl_of_lovelace
gaston_comte_deu	parents	louis_duke_of_nemours
teodosio_prince_of_brazil	gender	male
reccesuinth	gender	male
abraham	children	isaac
george_c_scott	gender	male
christian_ii_of_denmark	children	christina_of_denmark
feodor_iii_of_russia	profession	monarch
prince_leopold_of_bavaria	place_of_death	munich
sylvia_brett	nationality	united_kingdom
ada_lovelace	place_of_birth	london
elizabeth_woodville	gender	female
yongzheng_emperor	place_of_death	beijing
charles_talbot_1st_baron_talbot_of_hensol	profession	politician
germanicus	cause_of_death	assassination
sorghaghtani_beki	children	ariq_boke
louise_of_baden	parents	karl_ludwig_of_baden
eleanor_wilson_mcadoo	gender	female
napoleon_louis_bonaparte	parents	hortense_de_beauharnais
techichpotzin	parents	moctezuma_ii
william_greenleaf_eliot	gender	male
alice_spencer	children	lady_elizabeth_stanley
robert_e_lee	institution	united_states_military_academy
enno_louis_prince_of_ostfriesland	parents	ulrich_ii_count_of_ostfriesland
charles_iv_of_spain	religion	catholicism
adolphus_cambridge_1st_marquess_of_cambridge	children	mary_somerset_duchess_of_beaufort
john_i_albert_of_poland	location	krakow
mae_west	gender	female
frederick_william_ii_of_prussia	children	wilhelmine_of_prussia
william_shakespeare	profession	writer
haile_selassie_i_of_ethiopia	profession	monarch
john_sigismund_elector_of_brandenburg	children	maria_eleonora_of_brandenburg
nefertari	spouse	ramesses_ii
julia_lennon	nationality	united_kingdom
claude_of_valois	place_of_death	nancy
sonia_greene	spouse	h_p_lovecraft
philip_iii_duke_of_burgundy	place_of_birth	dijon
louise_defeo	location	new_york_state
prince_augustus_frederick_duke_of_sussex	place_of_birth	buckingham_palace
prince_maurice_of_battenberg	nationality	united_kingdom
maria_alexandrovna_of_russia	nationality	united_kingdom
hugh_de_stafford_2nd_earl_of_stafford	children	edmund_stafford_5th_earl_of_stafford
napoleon_ii_of_france	parents	napoleon_i_of_france
alexander_farnese_duke_of_parma	nationality	spain
sigrid_the_haughty	spouse	sweyn_i_of_denmark
alfonso_iv_of_leon	parents	ordono_ii_of_leon
sunandha	gender	female
claus_spreckels	children	john_d_spreckels
pedro_ii_of_brazil	spouse	teresa_of_the_two_sicilies
ronald_reagan	nationality	united_states
jennie_churchill	gender	female
caroline_webster_schermerhorn_astor	spouse	william_backhouse_astor_jr
john_burnside_1916	gender	male
huey_long	profession	governor
anna_orzelska	place_of_death	avignon
fruela_ii_of_leon	gender	male
amschel_mayer_rothschild	profession	banker
alfonso_carlos_duke_of_san_jaime	gender	male
mahmud_ghazan	gender	male
minamoto_no_yoritomo	children	minamoto_no_sanetomo
robert_a_heinlein	institution	united_states_naval_academy
ferdinand_maria_elector_of_bavaria	spouse	henriette_adelaide_of_savoy
henry_iii_jules_de_bourbon_prince_de_conde	gender	male
vespasian	profession	roman_emperor
marguerite_of_france	place_of_birth	paris
benjamin_thompson	nationality	united_kingdom
infanta_beatriz_of_spain	gender	female
alva_belmont	children	consuelo_vanderbilt
claude_of_france	children	francois_dauphin_of_france
roza_laborfalvi	place_of_birth	miskolc
grand_duke_nicholas_nicolaevich_the_younger	nationality	russia
thomas_palaiologos	gender	male
christian_i_elector_of_saxony	place_of_birth	dresden
elizabeth_i_of_england	profession	poet
winston_churchill	spouse	clementine_churchill_baroness_spencer_churchill
franz_liszt	nationality	germany
mel_ferrer	place_of_death	santa_barbara
james_ii_of_scotland	gender	male
amedeo_3rd_duke_of_aosta	gender	male
henrietta_maria_of_france	children	henrietta_anne_stuart
john_rolfe	religion	church_of_england
joan_crawford	cause_of_death	pancreatic_cancer
frederick_ii_landgrave_of_hesse	place_of_birth	kassel
matilda_of_ringelheim	children	otto_i_holy_roman_emperor
ottavio_farnese_duke_of_parma	gender	male
agnes_of_france_duchess_of_burgundy	children	margaret_of_burgundy_queen_of_navarre
victoria_kinoiki_kekaulike	gender	female
yixuan_1st_prince_chun	children	guangxu_emperor
elisabeth_of_austria_1526	parents	ferdinand_i_holy_roman_emperor
alfonso_vii_of_leon	ethnicity	galician_people
princess_helena_of_the_united_kingdom	gender	female
simon_guggenheim	gender	male
louis_of_toulouse	nationality	france
winston_churchill	nationality	united_kingdom
casimir_iv_jagiellon	children	john_i_albert_of_poland
lilian_baels	gender	female
prince_frederick_of_hesse	gender	male
indira_gandhi	profession	politician
false_dmitriy_i	cause_of_death	firearm
ray_bridwell_white	institution	bachelor_of_arts
sigurd_ibsen	profession	politician
maria_of_spain	spouse	maximilian_ii_holy_roman_emperor
chulalongkorn	spouse	saovabha
richard_i_of_england	parents	henry_ii_of_england
caroline_of_baden	place_of_birth	karlsruhe
scribonia	gender	female
alexis_i_of_russia	profession	monarch
madeleine_de_bourbon-busset	children	carlos_hugo_of_bourbon_duke_of_parma
edward_r_murrow	spouse	janet_huntington_brewster
archduke_johann_of_austria	parents	maria_louisa_of_spain
anna_deste	parents	renee_of_france
philippa_of_lancaster	children	infante_joao_of_portugal
nicholas_i_of_montenegro	institution	lycee_louis_le_grand
adele_of_champagne	gender	female
maria_of_habsburg_archduchess_of_austria	place_of_birth	prague
albert_vii_archduke_of_austria	spouse	infanta_isabella_clara_eugenia_of_spain
john_iv_of_portugal	children	teodosio_prince_of_brazil
marie-anne_pierrette_paulze	gender	female
alexander_serov	children	valentin_serov
edmund_tudor_1st_earl_of_richmond	cause_of_death	bubonic_plague
princess_viktoria_luise_of_prussia	nationality	germany
marvin_gaye	ethnicity	african_american
alice_of_bourbon_parma	children	josef_ferdinand
franz_josef_i_prince_of_liechtenstein	location	milan_italy
marguerite_of_france	children	eleanor_of_castile
archduchess_maria_beatrix_of_austria_este	place_of_death	graz
george_iv_of_the_united_kingdom	place_of_birth	st_jamess_palace
irene_joliot-curie	nationality	france
prince_frederick_duke_of_york_and_albany	gender	male
nicholas_ii_of_russia	cause_of_death	assassination
alfonso_x_of_castile	profession	writer
valentin_serov	parents	alexander_serov
afonso_1st_duke_of_braganza	parents	john_i_of_portugal
alexandra_fyodorovna_of_hesse	children	tsarevich_alexei_nikolaevich_of_russia
henry_vii_of_england	spouse	elizabeth_of_york
adolphe_grand_duke_of_luxembourg	gender	male
mihrimar	parents	roxelana
mihailo_obrenovic_iii_prince_of_serbia	gender	male
princess_louise_victoire_dorleans_alencon	children	prince_joseph_clemens_of_bavaria
mary_josephine_hannon_fitzgerald	gender	female
philip_ii_of_taranto	parents	philip_i_of_taranto
john_f_kennedy_jr	profession	lawyer
christian_bohr	nationality	denmark
julia_lennon	gender	female
sweyn_i_of_denmark	gender	male
niels_bohr	parents	christian_bohr
solomon_r_guggenheim	profession	businessperson
charles_talbot_1st_baron_talbot_of_hensol	institution	oriel_college
abaqa_khan	gender	male
archduke_maximilian_franz_of_austria	parents	francis_i_holy_roman_emperor
nicholas_i_of_russia	profession	monarch
maria_anna_of_pfalz-neuburg	parents	landgravine_elisabeth_amalie_of_hesse_darmstadt
valentin_serov	institution	imperial_academy_of_arts
isabel_burton	spouse	richard_burton
sarah_lennox_duchess_of_richmond	nationality	united_kingdom
basil_ii	parents	theophano
prince_sigismund_of_prussia	parents	victoria_princess_royal
john_rolfe	gender	male
john_carradine	profession	actor
kublai_khan	gender	male
charles_de_valois_duc_dorleans	parents	claude_of_france
prince_august_wilhelm_of_prussia	location	potsdam
berenice_ii	gender	female
napoleon_ii_of_france	parents	marie_louise_duchess_of_parma
kishore_kumar	profession	singer
thomas_plantagenet_2nd_earl_of_lancaster	gender	male
grand_duke_dmitri_konstantinovich_of_russia	parents	grand_duke_konstantin_nikolayevich_of_russia
henry_viii_of_england	profession	monarch
guillaume_iv_grand_duke_of_luxembourg	religion	catholicism
roger_sherman_hoar	parents	sherman_hoar
albert_of_saxe-coburg_and_gotha	children	princess_louise_duchess_of_argyll
ellen_franz	parents	bernhard_ii_erich_freund_duke_of_saxe_meiningen
liutgard	gender	female
kublai_khan	children	zhenjin
anna_of_bohemia_and_hungary	children	maria_of_habsburg_archduchess_of_austria
lynn_redgrave	profession	photographer
william_henry_vanderbilt	gender	male
infante_joao_of_portugal	parents	john_i_of_portugal
elisabeth_ii_of_bohemia	children	elisabeth_of_austria
frederika_of_hanover	parents	ernest_augustus_iii_duke_of_brunswick
william_of_winchester_lord_of_lunenburg	children	otto_i_duke_of_brunswick_luneburg
prince_georg_of_bavaria	parents	archduchess_gisela_of_austria
queen_emma_of_hawaii	children	albert_kamehameha
charles_spurgeon	religion	christian
maria_fyodorovna	parents	christian_ix_of_denmark
henry_viii_of_england	parents	henry_vii_of_england
francis_ii_holy_roman_emperor	nationality	austria
philip_i_of_castile	children	isabella_of_burgundy
ivan_v_of_russia	nationality	russia
frank_lloyd_wright	religion	unitarian_universalism
sigismund_iii_vasa	children	wladyslaw_iv_vasa
infanta_maria_das_neves_of_portugal	place_of_birth	kleinheubach
princess_tenagnework	parents	haile_selassie_i_of_ethiopia
thomas_spurgeon	place_of_birth	london
charles_xiv_john_of_sweden	ethnicity	french_people
luis_munoz_marin	profession	poet
mary_of_teck	cause_of_death	lung_cancer
maria_eleonora_of_brandenburg	children	christina_of_sweden
olaf_ii_of_norway	children	magnus_i_of_norway
charles_ii_of_naples	gender	male
favila_of_asturias	parents	pelayo_of_asturias
georg_i_frederick_karl_duke_of_saxe_meiningen	gender	male
charlotte_of_spain	parents	charles_iv_of_spain
matilda_of_flanders	spouse	william_i_of_england
hudson_taylor	profession	writer
frederick_william_iii_of_prussia	nationality	germany
anne_boleyn	cause_of_death	decapitation
clark_gable	nationality	united_states
verina	spouse	leo_i
ferdinand_maria_elector_of_bavaria	children	violante_of_bavaria
eleonore_of_solms_hohensolms_lich	children	georg_donatus_hereditary_grand_duke_of_hesse
miguel_of_portugal	children	maria_josepha_of_portugal
prince_heinrich_of_prussia	parents	frederick_iii_german_emperor
john_george_iii_elector_of_saxony	parents	john_george_ii_elector_of_saxony
louise_henriette_de_bourbon_conti	spouse	louis_philippe_i_duke_of_orleans
charles_iii_of_spain	religion	catholicism
luis_munoz_marin	religion	roman_catholic_church
albert_ii_margrave_of_meissen	children	frederick_i_margrave_of_meissen
edward_william_godwin	spouse	ellen_terry
alice_betty_stern	gender	female
julia_ward_howe	religion	unitarian_universalism
abraham	religion	judaism
william_i_of_scotland	nationality	kingdom_of_scotland
louis_xvi_of_france	children	princess_sophie_helene_beatrix_of_france
lord_george_lennox	gender	male
princess_victoria_of_hesse_and_by_rhine	place_of_death	kensington_palace
john_jacob_astor_iv	parents	william_backhouse_astor_jr
muhammad_ali_shah	gender	male
george_iii_of_the_united_kingdom	place_of_death	windsor_castle
peter_iv_of_aragon	parents	alfonso_iv_of_aragon
francois_dauphin_of_france	gender	male
oliver_cromwell	institution	university_of_cambridge
gaston_duke_of_orleans	nationality	kingdom_of_france
ernest_of_bavaria	gender	male
empress_jito	profession	writer
lilli_palmer	spouse	carlos_thompson
elizabeth_of_bohemia	children	prince_maurice_von_simmern
princess_ileana_of_romania	gender	female
yixin_prince_gong	gender	male
eunice_kennedy_shriver	location	chicago
frederick_william_ii_of_prussia	gender	male
john_ii_komnenos	children	alexius_comnenus
marie_de_luxembourg_queen_of_france	spouse	charles_iv_of_france
minnie_marx	children	chico_marx
louise_of_mecklenburg-strelitz	parents	charles_ii_grand_duke_of_mecklenburg_strelitz
chiang_kai-shek	cause_of_death	pneumonia
helena_draga	spouse	manuel_ii_palaiologos
isabella_stewart_princess_of_scotland	parents	james_i_of_scotland
ferdinand_i_of_the_two_sicilies	gender	male
hugh_percy_2nd_duke_of_northumberland	gender	male
charles_longuet	gender	male
alexander_kara_or_evic_prince_of_serbia	parents	kara_or_e_petrovic
hudson_taylor	place_of_birth	barnsley
leonora_of_england	spouse	alfonso_viii_of_castile
princess_louise_of_prussia	place_of_death	baden-baden
ferdinand_i_of_the_two_sicilies	parents	maria_amalia_of_saxony
lord_robert_manners	nationality	united_kingdom
eleanor_roosevelt	place_of_birth	new_york
archduke_friedrich_duke_of_teschen	gender	male
robert_of_naples	parents	charles_ii_of_naples
william_de_morgan	nationality	england
major_ridge	place_of_birth	tennessee
hussein_of_jordan	gender	male
james_dwight_dana	nationality	united_states
sophia_of_prussia	children	elena_of_greece_and_denmark
louis_duke_of_savoy	place_of_death	lyon
blanche_of_castile	parents	alfonso_viii_of_castile
washington_roebling	profession	engineer
helen_vinson	spouse	fred_perry
joseph_p_kennedy_jr	institution	harvard_university
manuel_ii_palaiologos	gender	male
alfonso_viii_of_castile	parents	sancho_iii_of_castile
john_barrymore	religion	catholicism
george_washington_parke_custis	profession	writer
beatrice_ephrussi_de_rothschild	place_of_death	davos
jenny_von_westphalen	place_of_death	london
grey_owl	nationality	canada
princess_cecilie_of_greece_and_denmark	parents	prince_andrew_of_greece_and_denmark
gian_gastone_de_medici_grand_duke_of_tuscany	place_of_death	florence
henry_iii_of_england	parents	john_of_england
aristotle_onassis	place_of_death	neuilly-sur-seine
nicholas_ii_of_russia	parents	maria_fyodorovna
ranuccio_i_farnese_duke_of_parma	gender	male
john_burnside_1916	spouse	harry_hay
princess_charlotte_augusta_of_wales	gender	female
teimuraz_ii	gender	male
john_elector_of_saxony	children	john_ernest_duke_of_saxe_coburg
maria_alexandrovna_of_russia	place_of_death	zurich
edith_of_scotland	place_of_death	palace_of_westminster
edward_smith_stanley_14th_earl_of_derby	parents	edward_smith_stanley_13th_earl_of_derby
harry_hay	spouse	john_burnside_1916
mary_dimmick_harrison	gender	female
anne_of_cleves	parents	john_iii_duke_of_cleves
enno_louis_prince_of_ostfriesland	place_of_birth	aurich
robert_c_wickliffe	nationality	united_states
maria_of_spain	parents	charles_v_holy_roman_emperor
berenguer_ramon_i_count_of_barcelona	nationality	spain
marguerite_louise_dorleans	spouse	cosimo_iii_de_medici_grand_duke_of_tuscany
zeb-un-nissa	location	agra
ann_dunham	nationality	united_states
eleanor_of_austria	nationality	austria
claus_spreckels	children	adolph_b_spreckels
karl_anselm_4th_prince_of_thurn_and_taxis	gender	male
elizabeth_i_of_england	gender	female
maria_alexandrovna_of_russia	children	princess_beatrice_of_edinburgh_and_saxe-coburg-gotha
grand_duke_dmitri_konstantinovich_of_russia	parents	alexandra_iosifovna_of_altenburg
alexander_kara_or_evic_prince_of_serbia	gender	male
huey_long	spouse	rose_mcconnell_long
gustav_iii_of_sweden	cause_of_death	regicide
j_p_morgan	profession	financier
stephen_ii_count_of_blois	parents	theobald_iii_count_of_blois
archduke_franz_ferdinand_of_austria	parents	archduke_carl_ludwig_of_austria
maria_amalia_of_saxony	children	gabriel_de_borbon
david_carradine	cause_of_death	hanging
sidney_herbert_1st_baron_herbert_of_lea	profession	politician
katarzyna_barbara_radziwill	parents	anna_katarzyna_sanguszko
henry_ii_of_england	parents	empress_matilda
elena_of_montenegro	children	princess_yolanda_margherita_of_savoy
katherine_mortimer_countess_of_warwick	place_of_birth	ludlow_castle
anna_sophia_ii_abbess_of_quedlinburg	gender	female
sten_sture_the_younger	nationality	sweden
john_matthew_defeo	gender	male
ethelbert_of_wessex	gender	male
kublai_khan	parents	tolui_borjigin
isabel_de_clare_4th_countess_of_pembroke	parents	eva_macmurrough
charles_e_mullen	parents	gunnery_sergeant_john_e_mullin
franz_xaver_wolfgang_mozart	parents	constanze_mozart
ethelwulf_of_wessex	children	ethelbald_of_wessex
postumus_junior	parents	postumus
takelot_iii	parents	osorkon_iii
princess_adelgunde_of_bavaria	place_of_birth	wurzburg
edward_of_portugal	gender	male
louis-philippe_of_france	children	francois_dorleans_prince_de_joinville
darius_ogden_mills	religion	episcopal_church_in_the_united_states_of_america
grace_kelly	institution	american_academy_of_dramatic_arts
charlotte_princess_royal	place_of_birth	buckingham_palace
anastasia_of_montenegro	location	cetinje
charles_a_wickliffe	children	robert_c_wickliffe
princess_nadejda_petrovna_of_russia	parents	grand_duke_peter_nicolaievich_of_russia
archduke_anton_prince_of_tuscany	gender	male
stanley_armour_dunham	gender	male
princess_mathilde_of_saxony	gender	female
john_ernest_duke_of_saxe_coburg	location	coburg
pulcheria	place_of_birth	constantinople
alphonse_james_de_rothschild	children	edouard_alphonse_de_rothschild
sylvia_plath	gender	female
edward_r_murrow	gender	male
thomas_edison	profession	scientist
prince_august_wilhelm_of_prussia	gender	male
simone_signoret	religion	judaism
philippe_i_duke_of_orleans	spouse	elizabeth_charlotte_princess_palatine
charles_spurgeon	nationality	england
ay	spouse	tey
sviatoslav_ii_of_kiev	place_of_death	kiev
maria_louisa_of_spain	children	rudolf_cardinal_von_habsburg_lothringen
isabella_of_bourbon	children	mary_of_burgundy
ludovico_sforza	place_of_death	loches
leka_crown_prince_of_albania	location	tirana
victor_emmanuel_iii_of_italy	spouse	elena_of_montenegro
george_boole	profession	mathematician
prince_bertil_duke_of_halland	profession	prince
francis_ii_of_france	gender	male
blanche_i_of_navarre	children	charles_of_viana
charles_darwin	religion	anglicanism
thomas_jefferson	place_of_birth	albemarle_county
edmund_tudor_1st_earl_of_richmond	gender	male
francis_ii_holy_roman_emperor	spouse	maria_teresa_of_the_two_sicilies
catherine_carey	parents	mary_boleyn
viveca_lindfors	ethnicity	swedish_people
prince_feodor_alexandrovich_of_russia	parents	grand_duke_alexander_mikhailovich_of_russia
augustus_iii_of_poland	children	frederick_christian_elector_of_saxony
henri_dorleans_duc_daumale	parents	louis-philippe_of_france
charles_albert_of_sardinia	spouse	maria_theresa_of_austria_and_tuscany
abigail_kapiolani_kawananakoa	parents	abigail_campbell_kawananakoa
h_p_lovecraft	ethnicity	english_americans
anne_of_cleves	gender	female
isabella_of_castile	religion	catholicism
william_gibbs_mcadoo	gender	male
prince_mircea_of_romania	gender	male
conrad_weiser	location	baden-wurttemberg
genghis_khan	ethnicity	mongols
h_p_lovecraft	profession	poet
adelheid_i_abbess_of_quedlinburg	religion	roman_catholic_church
princess_mary_of_great_britain	place_of_death	hanau
ferdinand_iv_grand_duke_of_tuscany	parents	marie_antoinette_of_tuscany
maria_theresa_of_austria	children	leopold_ii_holy_roman_emperor
john_vi_of_portugal	parents	peter_iii_of_portugal
archibald_cleghorn	gender	male
princess_hildegard_of_bavaria	parents	maria_theresia_of_austria-este
tsarevich_alexei_nikolaevich_of_russia	ethnicity	russians
darius_ogden_mills	children	ogden_mills
christina_of_saxony	spouse	john_i_of_denmark
henrietta_maria_of_france	nationality	kingdom_of_england
william_ii_german_emperor	parents	frederick_iii_german_emperor
philip_v_of_spain	gender	male
anton_philips	children	frits_philips
viveca_lindfors	ethnicity	swedish_american
kalama	spouse	kamehameha_iii
francis_i_holy_roman_emperor	nationality	austria
ferdinand_i_of_austria	religion	catholicism
eleanor_of_castile	spouse	edward_i_of_england
maria_theresa_of_austria	children	archduchess_maria_josepha_of_austria
miklos_horthy	gender	male
alice_of_the_united_kingdom	children	alexandra_fyodorovna_of_hesse
colleen_dewhurst	nationality	canada
mary_tudor	children	lady_frances_brandon
gaius_marius	spouse	julius_caesar
louis_xiv_of_france	gender	male
victoria_kinoiki_kekaulike	children	david_kawananakoa
shah_shuja	parents	mumtaz_mahal
venceslas_i_of_bohemia	parents	ottokar_i_of_bohemia
leonora_of_england	parents	henry_ii_of_england
frederick_ii_holy_roman_emperor	spouse	yolande_of_jerusalem
hetepheres	children	khufu
paul_i_of_russia	cause_of_death	murder
prince_frederick_duke_of_york_and_albany	place_of_death	london
bernhard_i_duke_of_saxe_meiningen	gender	male
prince_konrad_of_bavaria	location	munich
joan_de_geneville_baroness_geneville	nationality	kingdom_of_england
lady_elizabeth_stanley	spouse	henry_hastings_5th_earl_of_huntingdon
henry_v_count_palatine_of_the_rhine	parents	henry_the_lion
anthony_clement_of_saxony	gender	male
livilla	cause_of_death	starvation
paul_getty	gender	male
prince_miguel_duke_of_viseu	parents	miguel_ii_duke_of_braganza
john_ii_casimir_of_poland	parents	sigismund_iii_vasa
francis_duke_of_teck	spouse	princess_mary_adelaide_of_cambridge
louis_ix_of_france	gender	male
adolf_frederick_ii_duke_of_mecklenburg_strelitz	parents	adolf_frederick_i_duke_of_mecklenburg_schwerin
princess_cecilie_of_greece_and_denmark	gender	female
mahatma_gandhi	profession	lawyer
princess_adelgunde_of_bavaria	parents	maria_theresia_of_austria-este
kunigunde_of_austria	children	susanna_of_bavaria
chilperic_i	spouse	fredegund
mary_princess_royal_and_countess_of_harewood	nationality	united_kingdom
margaret_of_parma	gender	female
alexandra_fyodorovna_of_hesse	children	grand_duchess_anastasia_nikolaevna_of_russia
errol_flynn	nationality	united_states
eadgifu_of_england	spouse	charles_the_simple
maria_fyodorovna_of_russia	children	anna_pavlovna_of_russia
atia	children	octavia_minor
thomas_thynne_2nd_viscount_weymouth	children	thomas_thynne_1st_marquess_of_bath
john_elector_of_saxony	location	meissen
ann_dunham	cause_of_death	ovarian_cancer
aelia_paetina	children	claudia_antonia
maria_theresia_of_austria-este	children	princess_adelgunde_of_bavaria
roger_sherman_hoar	gender	male
john_f_kennedy	spouse	jacqueline_kennedy_onassis
maria_antonia_of_portugal	parents	adelaide_of_lowenstein_wertheim_rosenberg
henry_iii_holy_roman_emperor	children	henry_iv_holy_roman_emperor
louis_v_duke_of_bavaria	parents	louis_iv_holy_roman_emperor
princess_caroline_elizabeth_of_great_britain	gender	female
siegfried_wagner	profession	composer
jogaila	children	casimir_iv_jagiellon
ronald_reagan	profession	president
john_d_rockefeller_jr	gender	male
taufaahau_tupou_iv	profession	monarch
yaroslav_i_the_wise	spouse	olof_of_sweden
chagatai_khan	gender	male
elizabeth_bourchier	place_of_birth	london
louis_xvi_of_france	parents	louis_dauphin_de_france
landgravine_elisabeth_amalie_of_hesse_darmstadt	children	maria_sofia_of_the_palatinate
beatrice_of_england	nationality	england
archduke_anton_victor_of_austria	parents	maria_louisa_of_spain
kira_kirillovna_of_russia	spouse	louis_ferdinand_prince_of_prussia
ernest_hemingway	spouse	mary_welsh_hemingway
cairine_wilson	spouse	norman_frank_wilson
anne_duchess_of_maine	nationality	france
peter_i_of_brazil	religion	catholicism
philip_herbert_4th_earl_of_pembroke	gender	male
jacqueline_kennedy_onassis	institution	miss_porters_school
james_keteltas_hackett	profession	actor
edward_smith_stanley_14th_earl_of_derby	place_of_birth	knowsley_hall
anna_e_roosevelt	nationality	united_states
empress_myeongseong	gender	female
claudius	spouse	aelia_paetina
princess_sophie_helene_beatrix_of_france	parents	louis_xvi_of_france
walter_rothschild_2nd_baron_rothschild	ethnicity	jew
maria_antonia_of_portugal	gender	female
frederick_william_i_of_prussia	children	frederick_ii_of_prussia
william_gibbs_mcadoo	spouse	eleanor_wilson_mcadoo
mary_somerset_duchess_of_beaufort	gender	female
charles_i_of_sicily	parents	louis_viii_of_france
bobby_troup	institution	wharton_school_of_the_university_of_pennsylvania
savang_vadhana	parents	mongkut
blessed_virgin_mary	children	jesus
kenneth_thomson_2nd_baron_thomson_of_fleet	institution	upper_canada_college
p_j_kennedy	children	joseph_p_kennedy_sr
mary_i_of_scotland	spouse	francis_ii_of_france
mette_marit_crown_princess_of_norway	gender	female
grand_duchess_maria_nikolaevna_of_russia	nationality	russia
roger_de_mortimer_1st_earl_of_march	children	katherine_mortimer_countess_of_warwick
john_i_of_denmark	place_of_birth	aalborg
john_d_rockefeller_jr	children	nelson_rockefeller
haile_selassie_i_of_ethiopia	gender	male
carlos_i_of_portugal	gender	male
piye	parents	kashta
george_herbert_11th_earl_of_pembroke	parents	henry_herbert_10th_earl_of_pembroke
maria_of_habsburg_archduchess_of_austria	gender	female
prince_frederick_of_prussia	gender	male
ibrahim_adil_shah_ii	children	mohammed_adil_shah
anna_maria_luisa_de_medici	parents	marguerite_louise_dorleans
mongkut	parents	sri_suriyendra
maria_luisa_of_savoy	children	louis_of_spain
lilli_palmer	gender	female
elizabeth_woodville	children	thomas_grey_1st_marquess_of_dorset
juliana_maria_of_brunswick_wolfenbuttel	spouse	frederick_v_of_denmark
juliane_of_saxe-coburg-saalfeld	nationality	germany
mary_de_bohun	children	philippa_of_england
friedrich_ii_eugen_duke_of_wurttemberg	nationality	germany
rosemary_kennedy	gender	female
anne_boleyn	religion	anglicanism
mahatma_gandhi	institution	university_college_london
princess_louise_elisabeth_of_france	children	ferdinand_duke_of_parma
princess_sophie_helene_beatrix_of_france	gender	female
ferdinand_georg_of_saxe-coburg-gotha	parents	franz_frederick_anton_duke_of_saxe_coburg_saalfeld
chico_marx	profession	bandleader
john_vi_of_portugal	gender	male
scribonia	spouse	early_life_of_augustus
benjamin_disraeli_1st_earl_of_beaconsfield	spouse	mary_anne_disraeli_1st_viscountess_beaconsfield
maria_josepha_of_portugal	gender	female
georg_iii_duke_of_saxe_meiningen	gender	male
julia_lennon	profession	homemaker
archduchess_elisabeth_franziska_of_austria	children	maria_christina_of_austria
prince_alexander_of_hesse_and_by_rhine	children	alexander_prince_of_bulgaria
charles_iv_of_france	spouse	marie_de_luxembourg_queen_of_france
charles_xiii_of_sweden	parents	louisa_ulrika_of_prussia
james_a_bayard_jr	parents	james_a_bayard
bela_iii_of_hungary	gender	male
alexandra_fyodorovna	spouse	nicholas_i_of_russia
ethel_lilian_voynich	spouse	wilfrid_michael_voynich
mae_west	cause_of_death	stroke
geza_i_of_hungary	children	prince_almos
joan_crawford	spouse	franchot_tone
benjamin_harrison	spouse	mary_dimmick_harrison
haile_selassie_i_of_ethiopia	ethnicity	oromo
allison_defeo	parents	louise_defeo
william_ii_german_emperor	institution	university_of_bonn
francoise_marie_de_bourbon	children	duc_dorleans
archduke_franz_karl_of_austria	gender	male
j_p_morgan_jr	location	new_york
albert_of_saxe-coburg_and_gotha	location	bavaria
vasili_i_of_russia	nationality	russia
marie_antoinette_of_tuscany	religion	roman_catholic_church
charlemagne	profession	emperor
sarah_lennox_duchess_of_richmond	children	charles_lennox_3rd_duke_of_richmond
harry_hay	profession	teacher
nicholas_i_of_montenegro	gender	male
sylvia_brett	gender	female
john_ii_of_aragon	children	ferdinand_ii_of_aragon
henrietta_anne_stuart	cause_of_death	peritonitis
ulysses_s_grant_jr	parents	julia_grant
gheorghe_i_tasca	children	gheorghe_tasca
louis_duke_of_savoy	nationality	italy
piroska_of_hungary	children	manuel_i_komnenos
kamehameha_iii	gender	male
henry_ii_of_france	children	charles_ix_of_france
lilli_palmer	nationality	united_states
maximilian_ii_holy_roman_emperor	religion	catholicism
henri_victor_regnault	gender	male
ludwig_ii_of_bavaria	gender	male
olybrius	spouse	valentinian_iii
robert_borden	gender	male
george_iv_of_the_united_kingdom	children	princess_charlotte_augusta_of_wales
thomas_thynne_1st_marquess_of_bath	parents	thomas_thynne_2nd_viscount_weymouth
piam	spouse	mongkut
philip_iii_of_france	place_of_birth	poissy
katherine_mortimer_countess_of_warwick	parents	roger_de_mortimer_1st_earl_of_march
sylvia_likens	children	jenny_likens
william_henry_fitzhugh_lee	nationality	united_states
edna_best	gender	female
william_ii_german_emperor	nationality	germany
john_franklin	spouse	eleanor_anne_porden
elena_of_greece_and_denmark	parents	constantine_i_of_greece
catherine_dolgorukov	gender	female
prince_rupert_of_the_rhine	location	prague
anna_radziwill	spouse	konrad_iii_rudy
valentinian_iii	parents	galla_placidia
wilhelmine_of_bayreuth	place_of_birth	potsdam
diego_colon	parents	christopher_columbus
cosimo_iii_de_medici_grand_duke_of_tuscany	children	gian_gastone_de_medici_grand_duke_of_tuscany
rose_fitzgerald_kennedy	children	eunice_kennedy_shriver
otto_i_duke_of_saxony	parents	liudolf_duke_of_saxony
francis_iv_duke_of_modena	children	archduchess_maria_beatrix_of_austria_este
ivor_churchill_guest_1st_viscount_wimborne	gender	male
constance_of_arles	spouse	robert_ii_of_france
julius_caesar_drusus	children	tiberius_gemellus
constance_of_arles	place_of_death	melun
thomas_jefferson	institution	university_of_toronto_at_mississauga
abdulmecid	children	murad_v
elizabeth_cady_stanton	children	harriot_eaton_stanton_blatch
yolande_of_jerusalem	place_of_birth	acre_israel
sten_sture_the_younger	parents	svante_nilsson
edna_best	spouse	herbert_marshall
george_herbert_11th_earl_of_pembroke	gender	male
roger_sherman_hoar	institution	harvard_university
claude_of_france	spouse	francis_i_of_france
robert_i_duke_of_burgundy	parents	robert_ii_of_france
jane_wyman	gender	female
ted_hughes	children	nicholas_hughes
zofia_teofillia_danilowicz	children	john_iii_sobieski
bess_meredyth	spouse	michael_curtiz
charles_duke_of_lower_lorraine	gender	male
august_anheuser_busch_sr	children	adolphus_busch_iii
alexandra_vasilievna_countess_zhukavskaya	children	count_alexei_alexandrovich_belevsky_zhukovsky
henry_the_lion	children	william_of_winchester_lord_of_lunenburg
christina_of_sweden	gender	female
alexis_i_of_russia	children	natalya_alexeevna
carlos_duke_of_madrid	gender	male
lady_sarah_wilson	parents	john_spencer_churchill_7th_duke_of_marlborough
indira_gandhi	place_of_birth	allahabad
augustus_ii_the_strong	place_of_birth	dresden
grand_duchess_maria_nikolaevna_of_russia	gender	female
george_grossmith_jr	parents	george_grossmith
lili_damita	profession	actor
mary_of_burgundy	place_of_death	bruges
elizabeth_cady_stanton	nationality	united_states
isabella_of_angouleme	children	eleanor_of_england
eva_braun	place_of_birth	munich
charlotte_of_mecklenburg-strelitz	parents	princess_elizabeth_albertine_of_saxe-hildburghausen
anne_boleyn	children	elizabeth_i_of_england
marie-anne_pierrette_paulze	profession	chemist
arleen_whelan	profession	actor
harry_caray	location	st_louis_missouri
peter_iii_of_portugal	children	infanta_mariana_vitoria_of_portugal
lady_cynthia_mosley	parents	mary_curzon_baroness_curzon_of_kedleston
maria_alexandrovna_of_hesse	children	grand_duke_nicholas_alexandrovich_of_russia
lady_may_abel_smith	parents	princess_alice_countess_of_athlone
mae_west	profession	actor
robert_e_lee	spouse	mary_anna_custis_lee
maria_eleonora_of_brandenburg	spouse	gustavus_adolphus_of_sweden
alexander_iii_of_russia	profession	monarch
christian_x_of_denmark	children	frederick_ix_of_denmark
catherine_of_aragon	parents	ferdinand_ii_of_aragon
olga_feodorovna_grand_duchess_of_russia	children	grand_duke_alexei_mikhailovich_of_russia
david_lloyd_george	spouse	frances_stevenson
elisabeth_of_austria_1526	nationality	austria
thursday_october_christian	children	thursday_october_christian_ii
charles_xiv_john_of_sweden	children	oscar_i_of_sweden
christian_ii_of_denmark	gender	male
infanta_maria_de_la_paz_of_spain	spouse	prince_louis_ferdinand_of_bavaria
edwin_wijeyeratne	profession	diplomat
lloyd_wright	gender	male
edouard_alphonse_de_rothschild	gender	male
prince_christian_victor_of_schleswig-holstein	place_of_death	pretoria
yves_montand	cause_of_death	myocardial_infarction
sam_jaffe_1891	nationality	united_states
frederick_w_seward	institution	union_college
eugene_de_beauharnais	children	auguste_de_beauharnais_2nd_duke_of_leuchtenberg
jenny_von_westphalen	children	jenny_longuet
kublai_khan	place_of_death	khanbaliq
shah_jahan	location	agra
princess_elizabeth_of_england	gender	female
helen_vinson	nationality	united_states
marguerite_duchess_of_orleans	spouse	gaston_duke_of_orleans
david_ii_of_scotland	place_of_birth	dunfermline
james_dwight_dana	institution	yale_university
infanta_isabel_duchess_of_burgundy	children	charles_i_duke_of_burgundy
caesonia	gender	female
marie_antoinette	children	princess_sophie_helene_beatrix_of_france
jenny_longuet	spouse	charles_longuet
adolphus_busch_iii	gender	male
constanze_mozart	spouse	georg_nikolaus_von_nissen
mary_of_teck	gender	female
henry_herbert_10th_earl_of_pembroke	institution	eton_college
louis_the_pious	parents	charlemagne
alfonso_carlos_duke_of_san_jaime	parents	archduchess_maria_beatrix_of_austria_este
mariana_victoria_of_spain	children	benedita_dowager_princess_of_brazil
countess_palatine_caroline_of_zweibrucken	children	natalia_alexeievna_of_russia
ekaterina_svanidze	spouse	joseph_stalin
joan_de_geneville_baroness_geneville	children	katherine_mortimer_countess_of_warwick
pedro_ii_of_brazil	place_of_birth	rio_de_janeiro
susanna_of_bavaria	parents	kunigunde_of_austria
marguerite_duchess_of_orleans	children	marguerite_louise_dorleans
hudson_taylor	profession	missionary
william_de_morgan	spouse	evelyn_de_morgan
thomas_palaiologos	parents	manuel_ii_palaiologos
cleopatra_vii_of_egypt	ethnicity	greeks_in_egypt
arghun	children	mahmud_ghazan
cosimo_iii_de_medici_grand_duke_of_tuscany	place_of_birth	florence
ferdinand_ii_of_portugal	children	infanta_antonia_of_portugal
daniel_bernoulli	nationality	netherlands
louis_xvii_of_france	nationality	france
william_adelin	parents	edith_of_scotland
vipsania_agrippina	spouse	tiberius
juba_ii	spouse	cleopatra_selene
atia	nationality	roman_republic
meyer_guggenheim	children	solomon_r_guggenheim
francis_ii_holy_roman_emperor	place_of_death	vienna
maria_fyodorovna_of_russia	children	alexandra_pavlovna_of_russia
nicholas_ii_of_russia	children	grand_duchess_maria_nikolaevna_of_russia
john_lennon	nationality	united_kingdom
frederick_vii_of_denmark	nationality	denmark
george_c_scott	profession	actor
charles_iv_of_spain	children	francisco_de_paula_duke_of_cadiz
piroska_of_hungary	gender	female
caesonia	spouse	caligula
louis_dauphin_de_france	children	louis_xvi_of_france
louis_vii_of_france	gender	male
william_henry_fitzhugh_lee	location	arlington
emperor_kobun	spouse	princess_t_chi
george_iii_of_the_united_kingdom	nationality	kingdom_of_great_britain
alexandra_fyodorovna_of_hesse	place_of_death	yekaterinburg
ronald_reagan	parents	nelle_wilson_reagan
elizabeth_de_burgh	spouse	robert_i_of_scotland
adelaide_of_lowenstein_wertheim_rosenberg	place_of_birth	kleinheubach
frits_philips	gender	male
willem_van_keppel_2nd_earl_of_albemarle	gender	male
victoria_eugenia_of_battenberg	religion	catholicism
ethelbald_of_wessex	place_of_death	wessex
cosima_wagner	children	siegfried_wagner
ferdinand_duke_of_parma	children	louis_of_etruria
louis_viii_of_france	gender	male
khufu	children	djedefra
ealhswith	religion	catholicism
john_ridge	ethnicity	cherokee
francis_ii_holy_roman_emperor	children	ferdinand_i_of_austria
rose_fitzgerald_kennedy	location	barnstable
maria_theresia_of_austria-este	gender	female
august_anheuser_busch_sr	place_of_birth	st_louis_missouri
charles_emmanuel_iii_of_sardinia	religion	catholicism
robert_lowell	ethnicity	white_american
caroline_webster_schermerhorn_astor	gender	female
william_talbot	children	charles_talbot_1st_baron_talbot_of_hensol
john_vi_of_portugal	place_of_birth	lisbon
frederick_william_ii_of_prussia	spouse	elisabeth_christine_of_brunswick_luneburg
elizabeth_blair_lee	spouse	samuel_phillips_lee
prince_maurice_of_battenberg	gender	male
leopold_prince_of_hohenzollern_sigmaringen	children	ferdinand_i_of_romania
prince_feodor_alexandrovich_of_russia	parents	grand_duchess_xenia_alexandrovna_of_russia
prince_christian_victor_of_schleswig-holstein	parents	princess_helena_of_the_united_kingdom
henry_v_holy_roman_emperor	spouse	empress_matilda
robert_c_wickliffe	institution	centre_college
thomas_rolfe	parents	pocahontas
johann_bernoulli	children	daniel_bernoulli
abigail_campbell	place_of_death	honolulu
nicholas_hughes	parents	sylvia_plath
augusta_viktoria_of_schleswig-holstein	children	prince_eitel_friedrich_of_prussia
freddie_lennon	gender	male
theodora_0984	place_of_death	constantinople
george_talbot_6th_earl_of_shrewsbury	children	gilbert_talbot_7th_earl_of_shrewsbury
albert_of_saxe-coburg_and_gotha	children	princess_beatrice_of_the_united_kingdom
minamoto_no_sanetomo	parents	minamoto_no_yoritomo
mary_anne_disraeli_1st_viscountess_beaconsfield	gender	female
mary_anna_custis_lee	spouse	robert_e_lee
grand_duchess_maria_nikolaevna_of_russia	cause_of_death	firearm
marie_antoinette	location	vienna
john_f_kennedy_jr	cause_of_death	airplane_crash
pedro_ii_of_brazil	place_of_death	paris
j_presper_eckert	children	j_presper_eckert
philip_iii_of_france	religion	catholicism
prince_andrei_alexandrovich_of_russia	gender	male
cleopatra_vii_of_egypt	place_of_birth	alexandria
helen_vinson	gender	female
hermann_einstein	children	maria_winteler_einstein
frederick_iv_elector_palatine	gender	male
george_tabori	spouse	viveca_lindfors
elisabeth_of_bavaria	cause_of_death	assassination
princess_louise_of_denmark	children	christian_prince_of_schaumburg_lippe
joanna_of_castile	children	charles_v_holy_roman_emperor
sunandha	place_of_death	thailand
anne_of_bohemia	cause_of_death	bubonic_plague
magnus_iii_of_norway	gender	male
francoise_daubigne_marquise_de_maintenon	nationality	france
princess_beatrice_of_the_united_kingdom	children	prince_maurice_of_battenberg
charles_x_of_france	religion	catholicism
katarzyna_tomicka	gender	female
ethel_lilian_voynich	gender	female
prince_frederick_duke_of_york_and_albany	spouse	frederica_charlotte_of_prussia
andrey_bolshoy	parents	vasili_ii_of_russia
maria_miloslavskaya	children	feodor_iii_of_russia
francis_i_holy_roman_emperor	spouse	maria_theresa_of_austria
william_wyler	ethnicity	jew
augustus_de_morgan	children	william_de_morgan
frits_philips	institution	delft_university_of_technology
prince_christian_victor_of_schleswig-holstein	institution	magdalen_college_oxford
otto_frank	religion	jew
alexander_farnese_duke_of_parma	gender	male
victoria_eugenia_of_battenberg	spouse	alfonso_xiii_of_spain
marie_dagoult	place_of_birth	frankfurt
alexander_ii_of_russia	parents	alexandra_fyodorovna
sophia_alekseyevna	religion	russian_orthodox_church
oliver_belmont	place_of_death	hempstead
henry_herbert_2nd_earl_of_pembroke	nationality	kingdom_of_england
simone_signoret	location	wiesbaden
john_elector_of_saxony	location	saxony
charles_vii_holy_roman_emperor	profession	holy_roman_emperor
ariq_boke	parents	sorghaghtani_beki
archduchess_maria_anna	place_of_birth	vienna
princess_mathilde_of_bavaria	parents	therese_of_saxe_hildburghausen
elisabeth_of_bavaria	gender	female
william_greenleaf_eliot	institution	harvard_divinity_school
george_washington_parke_custis	children	mary_anna_custis_lee
minamoto_no_yoritomo	gender	male
louis_viii_of_france	children	isabel_of_france
crown_prince_wilhelm_of_germany	nationality	germany
mongkut	spouse	piam
adolf_hitler	spouse	eva_braun
prince_feodor_alexandrovich_of_russia	gender	male
ramon_berenguer_i_count_of_barcelona	parents	berenguer_ramon_i_count_of_barcelona
juliane_of_saxe-coburg-saalfeld	place_of_birth	coburg
louise_henriette_de_bourbon_conti	children	duc_dorleans
alexander_i_of_greece	cause_of_death	animal_attack
edward_r_murrow	ethnicity	english_people
joan_of_england_queen_of_sicily	gender	female
william_iv_of_the_united_kingdom	gender	male
alice_betty_stern	children	otto_frank
louis_hayward	cause_of_death	lung_cancer
lord_robert_manners	parents	john_manners_2nd_duke_of_rutland
john_ii_of_aragon	parents	ferdinand_i_of_aragon
belle_starr	nationality	united_states
henrietta_maria_of_france	nationality	kingdom_of_france
princess_alice_of_battenberg	gender	female
ferdinand_i_of_austria	nationality	hungary
yaroslav_i_the_wise	children	iziaslav_i_of_kiev
charles_ii_of_austria	children	anna_of_habsburg
maria_of_spain	children	albert_vii_archduke_of_austria
laura_borden	spouse	robert_borden
shah_jahan	children	dara_shikoh
akbar	spouse	jodhabai
marie_of_edinburgh	children	prince_mircea_of_romania
eleanor_of_england	nationality	england
marie_of_edinburgh	religion	anglicanism
rose_fitzgerald_kennedy	religion	catholicism
abigail_kapiolani_kawananakoa	gender	female
harpo_marx	spouse	susan_fleming
charles_ii_of_naples	children	blanche_of_anjou
lady_elizabeth_stanley	place_of_birth	knowsley_hall
louis_xiii_of_france	children	philippe_i_duke_of_orleans
charles_edison	nationality	united_states
elisabeth_of_austria	nationality	austria
charles_vii_holy_roman_emperor	children	maximilian_iii_elector_of_bavaria
victor_emmanuel_iii_of_italy	children	princess_mafalda_of_italy
wladyslaw_czartoryski	gender	male
james_ii_of_england	religion	catholicism
alexandra_iosifovna_of_altenburg	parents	amelia_of_wurttemberg
alexander_iii_of_russia	location	saint_petersburg
victoria_of_the_united_kingdom	cause_of_death	cerebral_hemorrhage
henry_of_portugal	nationality	portugal
winston_churchill	profession	writer
charles_vii_holy_roman_emperor	spouse	maria_amalia_of_austria
beatriz_of_portugal	spouse	infante_fernando_duke_of_viseu
elizabeth_i_of_england	religion	anglicanism
mrs_j_mullen	children	charles_e_mullen
anne_of_denmark	gender	female
elisabeth_of_bavaria_1876	parents	karl_theodor_duke_in_bavaria
luisa_of_medina-sidonia	children	catherine_of_braganza
ferdinand_iv_grand_duke_of_tuscany	children	josef_ferdinand
edward_the_elder	children	athelstan_of_england
paripatra	gender	male
john_ridge	ethnicity	native_americans_in_the_united_states
katherine_corri_harris	profession	actor
marie_de_medici	parents	johanna_of_austria
madhubala	spouse	kishore_kumar
john_a_roebling	children	washington_roebling
jahangir	children	shah_jahan
sophia_charlotte_of_hanover	nationality	germany
pocahontas	cause_of_death	smallpox
hussein_of_jordan	parents	talal_of_jordan
joan_crawford	place_of_birth	san_antonio
anne_of_brittany	place_of_death	blois
lilli_palmer	location	poznan
john_campbell_9th_duke_of_argyll	gender	male
susan_cullen-ward	cause_of_death	lung_cancer
louise_defeo	children	marc_defeo
ekaterina_svanidze	children	yakov_dzhugashvili
maximilian_joseph_duke_in_bavaria	children	elisabeth_of_bavaria
elizabeth_of_bohemia	spouse	frederick_v_elector_palatine
caroline_blackwood	location	london
cleopatra_iv_of_egypt	gender	female
josephine_de_beauharnais	gender	female
pauline_koch	gender	female
napoleon_ii_of_france	cause_of_death	tuberculosis
thomas_jefferson	religion	deism
shah_jahan	gender	male
nakkhatra_mangkala_kitiyakara	children	adulakit_kitiyakara
ferdinand_ii_of_the_two_sicilies	gender	male
josephine_de_beauharnais	spouse	alexandre_vicomte_de_beauharnais
constantine_xi	parents	manuel_ii_palaiologos
anastasia_of_montenegro	gender	female
charles_albert_of_sardinia	children	ferdinand_duke_of_genoa
benjamin_thompson	nationality	germany
shuja-ud-daula	place_of_birth	delhi
roy_e_disney	parents	roy_o_disney
yongzheng_emperor	ethnicity	manchu
margaret_of_burgundy_queen_of_navarre	spouse	louis_x_of_france
simeon_uro	parents	stefan_uro_iii_de_anski_of_serbia
princess_eugenie_of_sweden	parents	josephine_of_leuchtenberg
eric_xiv_of_sweden	gender	male
george_iii_of_the_united_kingdom	profession	monarch
marguerite_of_france_1158	spouse	bela_iii_of_hungary
catherine_of_braganza	parents	john_iv_of_portugal
edward_the_elder	parents	ealhswith
charlotte_of_mecklenburg-strelitz	children	charlotte_princess_royal
charles_lennox_2nd_duke_of_richmond	children	lord_george_lennox
philip_iii_of_navarre	parents	louis_devreux
jacqueline_kennedy_onassis	place_of_birth	southampton_new_york
stanley_armour_dunham	children	ann_dunham
sherman_hoar	children	roger_sherman_hoar
infanta_maria_teresa_of_spain	place_of_birth	madrid
khufu	children	hetepheres_ii
charles_darwin	location	shrewsbury
emperor_temmu	children	princess_t_chi
luz_magsaysay	gender	female
infante_carlos_count_of_molina	place_of_death	trieste
thomas_jefferson	profession	philosopher
chulalongkorn	children	paripatra
carlos_duke_of_madrid	place_of_birth	ljubljana
yongzheng_emperor	children	qianlong_emperor
hussein_of_jordan	spouse	alia_al_hussein
elizabeth_i_of_england	ethnicity	english_people
nicholas_hughes	cause_of_death	hanging
sorghaghtani_beki	gender	female
marie_antoinette	gender	female
queen_emma_of_hawaii	gender	female
john_frederick_elector_of_saxony	gender	male
catherine_parr	profession	poet
bess_meredyth	profession	actor
charlie_soong	children	soong_ai-ling
johann_i_josef_prince_of_liechtenstein	religion	catholicism
ethel_lilian_voynich	profession	author
ernest_of_bavaria	parents	albert_v_duke_of_bavaria
edward_ellice	nationality	united_kingdom
georg_ii_duke_of_saxe_meiningen	nationality	germany
soong_may-ling	religion	christianity
louise_henriette_de_bourbon_conti	gender	female
francis_i_holy_roman_emperor	religion	catholicism
rasmus_bartholin	profession	scientist
charles_ii_of_naples	children	philip_i_of_taranto
mary_i_of_scotland	religion	catholicism
betty_compson	gender	female
mayer_amschel_rothschild	gender	male
tey	spouse	ay
mieszko_iv_tanglefoot	parents	wladyslaw_ii_the_exile
hudson_taylor	nationality	united_kingdom
casimir_i_of_poland	gender	male
winston_churchill	nationality	england
miguel_of_portugal	children	infanta_maria_das_neves_of_portugal
caspar_bartholin_the_elder	institution	university_of_copenhagen
henri_i_de_bourbon_prince_de_conde	parents	eleanor_de_roucy_de_roye
tigranes_the_great	ethnicity	armenians
grand_duke_konstantin_nikolayevich_of_russia	nationality	russia
bertrade_de_montfort	children	fulk_of_jerusalem
philippe_ii_duke_of_orleans	gender	male
jane_wyman	place_of_death	palm_springs
afonso_vi_of_portugal	parents	luisa_of_medina-sidonia
anna_lee	gender	female
joan_of_england_queen_of_sicily	place_of_death	fontevraud_abbey
james_mayer_de_rothschild	ethnicity	jew
infanta_maria_of_guimaraes	spouse	alexander_farnese_duke_of_parma
maria_victoria_al_pozzo_della_cisterna	location	paris
mutnedjmet	gender	female
elena_pavlovna_of_wurttemberg	spouse	grand_duke_michael_pavlovich_of_russia
winston_churchill	institution	harrow_school
venetia_stanley_1887	religion	judaism
charibert_i	parents	clotaire_i
hortense_de_beauharnais	children	napoleon_iii_of_france
isabella_of_france	parents	philip_iv_of_france
prince_henry_duke_of_gloucester	institution	royal_military_academy_sandhurst
ferdinand_i_holy_roman_emperor	nationality	hungary
milo_obrenovic_i_prince_of_serbia	place_of_death	belgrade
edward_burgess	children	william_starling_burgess
antonia_major	gender	female
ernest_augustus_duke_of_york_and_albany	parents	sophia_of_hanover
frances_adeline_seward	spouse	william_h_seward
jacqueline_kennedy_onassis	children	john_f_kennedy_jr
philip_iv_of_spain	children	john_of_austria_the_younger
maria_amalia_of_saxony	place_of_birth	dresden
groucho_marx	location	new_york
victoria_of_the_united_kingdom	nationality	united_kingdom
pauline_koch	children	maria_winteler_einstein
anna_e_roosevelt	place_of_death	new_york
mary_anna_custis_lee	nationality	united_states
h_p_lovecraft	place_of_birth	providence
alexandra_fyodorovna	nationality	germany
archduchess_maria_anna	place_of_death	klagenfurt
frederick_iv_elector_palatine	place_of_birth	amberg
margaret_of_france_duchess_of_berry	parents	francis_i_of_france
elizabeth_macquarie	spouse	lachlan_macquarie
diego_colon	gender	male
anna_jagiellon	parents	bona_sforza
vilhelmine_marie_of_denmark	spouse	frederick_vii_of_denmark
maria_alexandrovna_of_hesse	place_of_death	saint_petersburg
assia_wevill	cause_of_death	carbon_monoxide_poisoning
cosima_wagner	parents	franz_liszt
marie_of_edinburgh	parents	alfred_duke_of_saxe_coburg_and_gotha
stephanie_of_hohenzollern_sigmaringen	gender	female
victoria_of_the_united_kingdom	children	prince_arthur_duke_of_connaught_and_strathearn
maria_of_brabant	parents	henry_iii_duke_of_brabant
joseph_stalin	profession	generalissimo
elena_of_montenegro	religion	catholicism
carlos_hugo_of_bourbon_duke_of_parma	location	paris
ludovico_sforza	nationality	italy
alexandra_pavlovna_of_russia	gender	female
edward_clinton_1st_earl_of_lincoln	spouse	elizabeth_clinton_countess_of_lincoln
eleanor_stewart_princess_of_scotland	parents	joan_beaufort_queen_of_scotland
sybil_thomas_viscountess_rhondda	spouse	david_alfred_thomas
penelope_blount_countess_of_devonshire	nationality	kingdom_of_england
charles_viii_of_france	parents	charlotte_of_savoy
john_barrymore	children	diana_barrymore
jennie_churchill	children	winston_churchill
franz_xaver_wolfgang_mozart	profession	pianist
otto_i_duke_of_brunswick_luneburg	gender	male
archduchess_maria_theresia_of_austria	place_of_death	leipzig
bela_iii_of_hungary	children	constance_of_hungary
napoleon_iii_of_france	nationality	france
charlotte_duchess_of_albany	cause_of_death	liver_cancer
talitha_getty	spouse	paul_getty
pesach_burstein	spouse	lillian_lux
julia_the_elder	gender	female
sophia_of_prussia	location	potsdam
margaret_de_bohun_2nd_countess_of_devon	parents	elizabeth_of_rhuddlan
magdalen_dacre_viscountess_montagu	religion	roman_catholic_church
frederick_ii_landgrave_of_hesse	spouse	princess_mary_of_great_britain
princess_marie_bonaparte	children	prince_peter_of_greece_and_denmark
thomas_palaiologos	children	sophia_paleologue
prince_georg_of_bavaria	parents	prince_leopold_of_bavaria
princess_beatrice_of_the_united_kingdom	parents	albert_of_saxe-coburg_and_gotha
alia_al_hussein	cause_of_death	aviation_accidents_and_incidents
roy_thomson_1st_baron_thomson_of_fleet	children	kenneth_thomson_2nd_baron_thomson_of_fleet
ronald_defeo_sr	spouse	louise_defeo
henry_iv_of_england	place_of_death	westminster
catherine_pavlovna_of_russia	parents	maria_fyodorovna_of_russia
emanuel_reicher	nationality	germany
maximilian_ii_of_bavaria	gender	male
princess_margaret_of_connaught	children	prince_bertil_duke_of_halland
george_darwin	parents	charles_darwin
sam_marx	children	groucho_marx
gabriel_de_borbon	gender	male
patricia_kennedy_lawford	place_of_death	new_york_county
hildegard_of_savoy	children	louis_the_pious
lady_sarah_wilson	parents	lady_frances_anne_emily_vane
boots_mallory	nationality	united_states
ottavio_farnese_duke_of_parma	parents	pier_luigi_farnese_duke_of_parma
samuel_gridley_howe	spouse	julia_ward_howe
rudolf_cardinal_von_habsburg_lothringen	profession	cardinal
adolf_frederick_of_sweden	children	prince_frederick_adolf_of_sweden
ghazi_of_iraq	children	faisal_ii_of_iraq
mary_of_teck	parents	princess_mary_adelaide_of_cambridge
frederica_charlotte_of_prussia	parents	frederick_william_ii_of_prussia
shabaka	gender	male
desiree_clary	nationality	france
caesarion	cause_of_death	capital_punishment
frederick_i_duke_of_saxe_gotha_altenburg	gender	male
mary_josephine_hannon_fitzgerald	spouse	john_f_fitzgerald
robert_mackay	children	cairine_wilson
franklin_d_roosevelt	parents	james_roosevelt_sr
princess_helena_of_the_united_kingdom	children	prince_christian_victor_of_schleswig-holstein
ida_lupino	gender	female
george_formby_ashton_under_lyne	nationality	england
henry_boehm	parents	martin_boehm
leatrice_joy	nationality	united_states
infanta_isabel_duchess_of_burgundy	parents	john_i_of_portugal
martha_jefferson_randolph	parents	thomas_jefferson
anahareo	profession	writer
james_e_ferguson	spouse	miriam_a_ferguson
mahmud_ii	children	abdulmecid
william_h_seward	profession	lawyer
princess_beatrice_of_the_united_kingdom	place_of_birth	buckingham_palace
bobby_troup	profession	actor
vasili_i_of_russia	parents	eudoxia_of_moscow
saovabha	parents	piam
chulalongkorn	children	kitiyakara_voralaksana
olaf_ii_of_norway	religion	roman_catholic_church
jodhabai	religion	hinduism
crown_prince_wilhelm_of_germany	gender	male
catherine_dolgorukov	spouse	alexander_ii_of_russia
richard_ii_of_england	gender	male
peter_i_of_brazil	gender	male
perkin_warbeck	parents	edward_iv_of_england
blanche_of_lancaster	parents	isabel_de_beaumont
beatrice_of_england	gender	female
philipp_wilhelm_elector_palatine	gender	male
empress_jito	spouse	emperor_temmu
saskia_van_uylenburg	place_of_birth	leeuwarden
oscar_i_of_sweden	nationality	sweden
john_i_of_portugal	children	infanta_isabel_duchess_of_burgundy
ferdinand_ii_of_portugal	children	infante_joao_duke_of_beja
henry_i_of_england	gender	male
princess_katherine_of_greece_and_denmark	gender	female
murad_ii	children	mehmed_ii
richard_burton	spouse	isabel_burton
marie_dagoult	children	cosima_wagner
nero_claudius_drusus	children	livilla
charles_i_of_england	children	princess_elizabeth_of_england
louis_vii_of_france	children	philip_ii_of_france
henry_i_of_england	spouse	edith_of_scotland
anne_of_bohemia	spouse	richard_ii_of_england
adolphus_busch_iii	parents	august_anheuser_busch_sr
gaston_duke_of_orleans	children	anne_duchess_of_montpensier
eadgifu_of_england	parents	edward_the_elder
ferdinand_i_of_romania	children	prince_mircea_of_romania
beatrice_of_england	children	blanche_of_brittany
princess_viktoria_luise_of_prussia	gender	female
konrad_iii_rudy	gender	male
joan_crawford	cause_of_death	myocardial_infarction
hortense_de_beauharnais	gender	female
casimir_i_of_poland	parents	mieszko_ii_lambert
stephen_i_of_hungary	place_of_birth	esztergom
napoleon_i_of_france	nationality	france
frederick_ii_holy_roman_emperor	children	conrad_iv_of_germany
amadeo_i_of_spain	place_of_birth	turin
ranuccio_i_farnese_duke_of_parma	children	odoardo_farnese
frederick_i_margrave_of_meissen	parents	albert_ii_margrave_of_meissen
soong_may-ling	institution	wellesley_college
willem_van_keppel_2nd_earl_of_albemarle	profession	groom_of_the_stool
archduke_carl_ludwig_of_austria	nationality	austria
penelope_blount_countess_of_devonshire	spouse	charles_blount_1st_earl_of_devonshire
adolf_frederick_i_duke_of_mecklenburg_schwerin	place_of_death	schwerin
archduke_charles_duke_of_teschen	gender	male
princess_alice_countess_of_athlone	parents	princess_helena_duchess_of_albany
joan_beaufort_queen_of_scotland	gender	female
francois_de_bourbon_prince_de_conti	place_of_death	paris
alfonso_xiii_of_spain	nationality	united_kingdom
robert_stewart_1st_duke_of_albany	children	john_stewart_2nd_earl_of_buchan
rudolph_i_of_bohemia	nationality	austria
mikolaj_vii_radziwill	parents	katarzyna_tomicka
prince_joseph_clemens_of_bavaria	parents	prince_alfons_of_bavaria
ernest_elector_of_saxony	parents	frederick_ii_elector_of_saxony
mor_jokai	spouse	roza_laborfalvi
eleonore_of_solms_hohensolms_lich	gender	female
james_i_of_scotland	children	james_ii_of_scotland
doris_blackburn	spouse	maurice_blackburn
mutemwiya_wife_of_thutmose_iv	children	amenhotep_iii
francis_duke_of_teck	gender	male
isabella_of_jerusalem	spouse	humphrey_iv_of_toron
mongkut	children	narisara_nuvadtivongs
princess_helene_of_orleans	gender	female
philip_iii_duke_of_burgundy	spouse	bonne_of_artois
pretty_shield	profession	writer
vipsania_agrippina	gender	female
ines_mendoza	gender	female
ivy_cavendish_bentinck_duchess_of_portland	gender	female
alexandra_of_denmark	children	prince_albert_victor_duke_of_clarence
nakkhatra_mangkala_kitiyakara	place_of_death	bangkok
katherine_corri_harris	spouse	john_barrymore
isabella_of_france	location	paris
a_k_fazlul_huq	nationality	bangladesh
ottokar_i_of_bohemia	children	venceslas_i_of_bohemia
christian_prince_of_schaumburg_lippe	parents	princess_louise_of_denmark
archduchess_elisabeth_franziska_of_austria	children	archduke_friedrich_duke_of_teschen
princess_louise_of_denmark_and_norway	children	marie_sophie_of_hesse-kassel
casimir_margrave_of_brandenburg_bayreuth	gender	female
laura_devon	spouse	brian_kelly_hell
mumtaz_mahal	children	shah_shuja
charles_blount_1st_earl_of_devonshire	nationality	england
janet_huntington_brewster	spouse	edward_r_murrow
ellen_terry	children	edith_craig
georg_nikolaus_von_nissen	spouse	constanze_mozart
francis_iv_duke_of_modena	place_of_death	modena
roberto_rossellini	spouse	ingrid_bergman
constance_of_hungary	place_of_birth	hungary
harilal_gandhi	nationality	india
conrad_iv_of_germany	place_of_birth	andria
ferdinand_iii_of_castile	children	alfonso_x_of_castile
thomas_edison	children	charles_edison
grand_duke_nicholas_alexandrovich_of_russia	nationality	russia
louis_of_bourbon_duke_of_orleans	parents	francoise_marie_de_bourbon
augustus_iii_of_poland	religion	catholicism
charles_a_wickliffe	nationality	united_states
eleanor_of_provence	parents	ramon_berenguer_iv_count_of_provence
elisabeth_of_bavaria	location	munich
frederick_iii_elector_of_saxony	parents	ernest_elector_of_saxony
frederick_iii_german_emperor	gender	male
ethel_lilian_voynich	parents	george_boole
gisela_of_swabia	children	henry_iii_holy_roman_emperor
consuelo_vanderbilt	nationality	united_states
philip_iii_of_navarre	children	blanche_devreux
alva_belmont	gender	female
geza_of_hungary	parents	taksony_of_hungary
anna_of_bohemia_and_hungary	children	eleanor_of_austria
paripatra	parents	chulalongkorn
marcus_vipsanius_agrippa	profession	statesman
elena_of_montenegro	place_of_birth	cetinje
philip_i_of_taranto	gender	male
walter_rothschild_2nd_baron_rothschild	profession	politician
gilbert_gallegos	spouse	linda_gallegos
alice_spencer	religion	anglicanism
jawaharlal_nehru	children	indira_gandhi
victoria_princess_royal	gender	female
lucius_aelius	children	lucius_verus
princess_caroline_elizabeth_of_great_britain	parents	george_ii_of_great_britain
francisco_de_paula_duke_of_cadiz	parents	charles_iv_of_spain
clodoald	place_of_birth	paris
john_f_fitzgerald	profession	politician
james_ii_of_england	gender	male
franz_frederick_anton_duke_of_saxe_coburg_saalfeld	children	juliane_of_saxe-coburg-saalfeld
joe_keaton	gender	male
victoria_kinoiki_kekaulike	place_of_death	honolulu
princess_marie_auguste_of_anhalt	parents	eduard_duke_of_anhalt
wang_khan	children	sorghaghtani_beki
charles_iv_of_france	gender	male
domitilla_the_elder	children	domitilla_the_younger
julia_lennon	children	john_lennon
john_barrymore	nationality	united_states
doris_blackburn	nationality	australia
anne_duchess_of_montpensier	parents	marie_de_bourbon_duchess_of_montpensier
louis_ix_of_france	religion	catholicism
algirdas	gender	male
isabella_of_angouleme	nationality	england
hermann_van_pels	location	lower_saxony
joseph_i_of_portugal	religion	catholicism
caspar_bartholin_the_elder	gender	male
john_ridge	parents	major_ridge
goes_ahead	spouse	pretty_shield
algirdas	religion	paganism
roger_sherman_hoar	profession	novelist
isabel_burton	nationality	united_kingdom
charles_iv_of_spain	place_of_birth	portici
prince_valdemar_of_denmark	nationality	denmark
alexander_iii_of_russia	profession	emperor
ferdinand_i_holy_roman_emperor	parents	philip_i_of_castile
maria_of_brabant	children	louis_devreux
maria_luisa_of_savoy	spouse	philip_v_of_spain
robert_anderson_1917	gender	male
elena_of_greece_and_denmark	spouse	carol_ii_of_romania
franz_liszt	religion	catholicism
christina_rossetti	parents	gabriele_rossetti
michael_redgrave	cause_of_death	parkinsons_disease
princess_sophie_of_greece_and_denmark	parents	prince_andrew_of_greece_and_denmark
augustus_ii_the_strong	children	anna_orzelska
wilhelmine_of_bayreuth	parents	frederick_william_i_of_prussia
thomas_jefferson	profession	architect
caroline_benn	spouse	tony_benn
princess_louise_elisabeth_of_france	place_of_birth	palace_of_versailles
ferdinand_i_of_austria	gender	male
john_i_albert_of_poland	spouse	elisabeth_of_austria
princess_sophie_of_greece_and_denmark	gender	female
henry_viii_of_england	spouse	anne_boleyn
pieter_brueghel_the_elder	place_of_birth	breda
henry_iii_jules_de_bourbon_prince_de_conde	children	anne_duchess_of_maine
prince_andrew_of_greece_and_denmark	spouse	princess_alice_of_battenberg
sigrid_the_haughty	gender	female
louis_philippe_i_duke_of_orleans	parents	louis_of_bourbon_duke_of_orleans
indira_gandhi	religion	hinduism
isabel_burton	religion	roman_catholic_church
catherine_pavlovna_of_russia	gender	female
tantamani	parents	shabaka
catherine_willoughby	spouse	charles_brandon_1st_duke_of_suffolk
joan_beaufort_queen_of_scotland	spouse	james_i_of_scotland
stephen_i_of_hungary	parents	geza_of_hungary
otto_ii_holy_roman_emperor	profession	holy_roman_emperor
taufaahau_tupou_iv	parents	salote_tupou_iii_of_tonga
livilla	parents	antonia_minor
marguerite_of_france	parents	maria_of_brabant
lew_cody	gender	female
isabella_of_portugal	children	maria_of_spain
clodoald	parents	chlodomer
leo_i	gender	male
joachim_ernst_duke_of_anhalt	parents	eduard_duke_of_anhalt
tyrone_power	nationality	united_states
archduke_louis_of_austria	gender	male
leopold_ii_holy_roman_emperor	children	archduke_joseph_of_austria_palatine_of_hungary
siegfried_wagner	profession	conducting
mariana_victoria_of_spain	parents	philip_v_of_spain
julius_caesar	gender	male
eduard_duke_of_anhalt	children	joachim_ernst_duke_of_anhalt
crown_prince_wilhelm_of_germany	parents	william_ii_german_emperor
guangxu_emperor	parents	yixuan_1st_prince_chun
garcia_i_of_leon	parents	alfonso_iii_of_leon
princess_helene_of_orleans	nationality	france
isabel_of_spain_princess_of_asturias	parents	ferdinand_ii_of_the_two_sicilies
clementine_churchill_baroness_spencer_churchill	children	diana_churchill
william_petty_2nd_earl_of_shelburne	children	henry_petty_fitzmaurice_3rd_marquess_of_lansdowne
chiang_kai-shek	religion	christianity
natalia_alexeievna_of_russia	parents	countess_palatine_caroline_of_zweibrucken
julia_the_elder	parents	scribonia
laura_marx	location	france
mayer_amschel_rothschild	children	amschel_mayer_rothschild
carlos_hugo_of_bourbon_duke_of_parma	parents	madeleine_de_bourbon-busset
leka_crown_prince_of_albania	parents	geraldine_apponyi_de_nagy-apponyi
wladyslaw_iv_vasa	religion	catholicism
prince_william_of_hesse	nationality	germany
princess_alexandra_of_edinburgh_and_saxe-coburg-gotha	place_of_birth	coburg
john_f_kennedy_jr	profession	businessperson
lionel_de_rothschild	nationality	united_kingdom
dante_gabriel_rossetti	profession	illustrator
alexandra_vasilievna_countess_zhukavskaya	gender	female
charles_edward_stuart	gender	male
roxelana	religion	islam
john_i_of_denmark	nationality	sweden
julius_caesar	children	aurelia_cotta
charles_peirce	institution	harvard_university
paul_newman	religion	unitarian_universalism
grand_duke_peter_nicolaievich_of_russia	place_of_birth	saint_petersburg
ramon_berenguer_ii_count_of_barcelona	children	ramon_berenguer_iii_count_of_barcelona
maximilian_i_elector_of_bavaria	spouse	maria_anna_of_austria
marjorie_merriweather_post	spouse	joseph_e_davies
princess_viktoria_luise_of_prussia	parents	augusta_viktoria_of_schleswig-holstein
alice_of_the_united_kingdom	parents	victoria_of_the_united_kingdom
princess_yolanda_margherita_of_savoy	gender	female
joseph_stalin	gender	male
louis_duke_of_nemours	children	gaston_comte_deu
archduke_franz_ferdinand_of_austria	children	prince_ernst_von_hohenberg
erekle_i_of_kakheti	children	teimuraz_ii
ferdinand_ii_of_aragon	nationality	spain
thomas_jefferson	nationality	united_states
jakub_ludwik_sobieski	nationality	poland
richard_mulligan	gender	male
princess_sophie_von_hohenberg	parents	archduke_franz_ferdinand_of_austria
baldwin_v_count_of_flanders	gender	male
afonso_v_of_portugal	gender	male
archduchess_maria_theresia_of_austria	place_of_birth	florence
frits_philips	parents	anton_philips
john_lennon	location	liverpool
louis_antoine_duke_of_angouleme	parents	marie_therese_of_savoy
anna_e_roosevelt	cause_of_death	throat_cancer
princess_helena_duchess_of_albany	children	princess_alice_countess_of_athlone
pauline_koch	nationality	germany
alexander_darcy	spouse	arleen_whelan
john_albert_vasa	gender	male
anne_of_great_britain	spouse	george_of_denmark
francesco_i_deste	gender	male
alfonso_xiii_of_spain	location	rome
fred_perry	gender	male
john_ii_of_aragon	gender	male
